FIPS,STNAME,CTYNAME,TOT_POP,TOT_MALE,TOT_FEMALE,WA_MALE,WA_FEMALE,NHWA_MALE,NHWA_FEMALE,NHWhite_Alone,Not_NHWhite_Alone,MinorityMinority,MinorityPCT,Black,BlackPCT,Hispanic,HispanicPCT
18049,Indiana,Fulton County,20737,10369,10368,9985,10020,9561,9627,19188,1549,No,7.47%,170,1%,965,4.65%
18051,Indiana,Gibson County,33458,16642,16816,15873,16117,15648,15955,31603,1855,No,5.54%,667,2%,476,1.42%
18053,Indiana,Grant County,69330,33282,36048,29587,32460,28353,31398,59751,9579,No,13.82%,4936,7%,2656,3.83%
18055,Indiana,Greene County,32940,16479,16461,16179,16167,16029,15999,32028,912,No,2.77%,82,0%,351,1.07%
18057,Indiana,Hamilton County,289495,141103,148392,125675,131785,120979,127105,248084,41411,No,14.30%,11332,4%,10548,3.64%
18059,Indiana,Hancock County,70933,34932,36001,33383,34328,32829,33752,66581,4352,No,6.14%,1491,2%,1266,1.78%
18061,Indiana,Harrison County,39134,19579,19555,19107,19119,18795,18868,37663,1471,No,3.76%,231,1%,646,1.65%
18063,Indiana,Hendricks County,150434,75116,75318,67458,68468,65249,66455,131704,18730,No,12.45%,8311,6%,4855,3.23%
18065,Indiana,Henry County,49345,25337,24008,23856,23361,23439,23091,46530,2815,No,5.70%,1253,3%,756,1.53%
18067,Indiana,Howard County,82849,39921,42928,35465,38322,34468,37359,71827,11022,No,13.30%,5879,7%,2373,2.86%
18069,Indiana,Huntington County,36987,18149,18838,17685,18406,17386,18085,35471,1516,No,4.10%,165,0%,709,1.92%
18071,Indiana,Jackson County,43083,21452,21631,20717,20924,19323,19895,39218,3865,No,8.97%,365,1%,2607,6.05%
18073,Indiana,Jasper County,33456,16651,16805,16198,16377,15332,15524,30856,2600,No,7.77%,284,1%,1843,5.51%
18075,Indiana,Jay County,21366,10518,10848,10339,10654,10031,10378,20409,957,No,4.48%,72,0%,614,2.87%
18077,Indiana,Jefferson County,32554,15641,16913,15026,16166,14678,15832,30510,2044,No,6.28%,639,2%,768,2.36%
18079,Indiana,Jennings County,28161,14131,14030,13764,13721,13469,13434,26903,1258,No,4.47%,258,1%,631,2.24%
18081,Indiana,Johnson County,143191,70409,72782,66435,68967,64187,67039,131226,11965,No,8.36%,2157,2%,4702,3.28%
18083,Indiana,Knox County,38122,19271,18851,18259,18022,17923,17757,35680,2442,No,6.41%,1077,3%,661,1.73%
18085,Indiana,Kosciusko County,77609,38634,38975,37202,37718,34161,35121,69282,8327,No,10.73%,705,1%,5950,7.67%
18087,Indiana,LaGrange County,37521,18903,18618,18565,18288,17858,17681,35539,1982,No,5.28%,159,0%,1401,3.73%
18089,Indiana,Lake County,493618,238553,255065,172253,176058,133213,138085,271298,222320,No,45.04%,127341,26%,85940,17.41%
18091,Indiana,LaPorte County,111246,57571,53675,48563,47025,45505,44506,90011,21235,No,19.09%,12338,11%,6328,5.69%
18093,Indiana,Lawrence County,46078,22778,23300,22262,22698,21981,22417,44398,1680,No,3.65%,208,0%,642,1.39%
18095,Indiana,Madison County,130348,65090,65258,57257,58718,55196,57023,112219,18129,No,13.91%,10976,8%,4457,3.42%
18097,Indiana,Marion County,918977,443402,475575,302916,313769,261708,278900,540608,378369,No,41.17%,252056,27%,89527,9.74%
18099,Indiana,Marshall County,47024,23256,23768,22575,23093,20506,21208,41714,5310,No,11.29%,318,1%,4235,9.01%
18101,Indiana,Martin County,10260,5164,5096,5083,5007,5050,4964,10014,246,No,2.40%,22,0%,89,0.87%
18103,Indiana,Miami County,36486,19558,16928,17554,16102,17044,15801,32845,3641,No,9.98%,1684,5%,922,2.53%
18105,Indiana,Monroe County,141019,70167,70852,61800,62571,59869,60808,120677,20342,No,14.43%,4823,3%,4394,3.12%
18107,Indiana,Montgomery County,38254,19263,18991,18562,18444,17672,17708,35380,2874,No,7.51%,410,1%,1800,4.71%
18109,Indiana,Morgan County,69356,34327,35029,33593,34231,33173,33851,67024,2332,No,3.36%,306,0%,876,1.26%
18111,Indiana,Newton County,14044,7132,6912,6960,6747,6582,6405,12987,1057,No,7.53%,94,1%,796,5.67%
18113,Indiana,Noble County,47582,23766,23816,23192,23226,20830,21138,41968,5614,No,11.80%,288,1%,4640,9.75%
18115,Indiana,Ohio County,6079,3027,3052,2975,2996,2936,2967,5903,176,No,2.90%,27,0%,78,1.28%
18117,Indiana,Orange County,19690,9728,9962,9420,9684,9315,9593,18908,782,No,3.97%,200,1%,233,1.18%
18119,Indiana,Owen County,21380,10759,10621,10562,10364,10458,10246,20704,676,No,3.16%,79,0%,235,1.10%
18121,Indiana,Parke County,17069,8011,9058,7857,8586,7765,8491,16256,813,No,4.76%,412,2%,214,1.25%
18123,Indiana,Perry County,19462,10421,9041,9777,8855,9673,8750,18423,1039,No,5.34%,547,3%,223,1.15%
18125,Indiana,Pike County,12766,6390,6376,6279,6262,6207,6191,12398,368,No,2.88%,65,1%,158,1.24%
18127,Indiana,Porter County,165682,81358,84324,76154,78653,69414,71698,141112,24570,No,14.83%,5618,3%,14809,8.94%
18129,Indiana,Posey County,25599,12732,12867,12411,12549,12289,12440,24729,870,No,3.40%,242,1%,257,1.00%
18131,Indiana,Pulaski County,13124,6686,6438,6520,6263,6351,6109,12460,664,No,5.06%,112,1%,348,2.65%
18133,Indiana,Putnam County,37750,19963,17787,18248,17154,17945,16934,34879,2871,No,7.61%,1524,4%,632,1.67%
18135,Indiana,Randolph County,25815,12718,13097,12422,12800,11984,12477,24461,1354,No,5.25%,149,1%,821,3.18%
18137,Indiana,Ripley County,28583,14124,14459,13812,14135,13585,13950,27535,1048,No,3.67%,100,0%,483,1.69%
18139,Indiana,Rush County,17095,8434,8661,8252,8470,8154,8385,16539,556,No,3.25%,144,1%,202,1.18%
18141,Indiana,St. Joseph County,266344,129101,137243,106123,111560,97024,102955,199979,66365,No,24.92%,34612,13%,20546,7.71%
18143,Indiana,Scott County,23791,11686,12105,11459,11865,11293,11713,23006,785,No,3.30%,79,0%,379,1.59%
18145,Indiana,Shelby County,44471,22049,22422,21284,21700,20482,21002,41484,2987,No,6.72%,496,1%,1700,3.82%
18147,Indiana,Spencer County,20837,10498,10339,10282,10113,10019,9913,19932,905,No,4.34%,138,1%,533,2.56%
18149,Indiana,Starke County,23213,11489,11724,11236,11467,10865,11127,21992,1221,No,5.26%,98,0%,797,3.43%
18151,Indiana,Steuben County,34124,17289,16835,16834,16397,16321,15947,32268,1856,No,5.44%,242,1%,1066,3.12%
18153,Indiana,Sullivan County,21188,11466,9722,10381,9527,10171,9440,19611,1577,No,7.44%,938,4%,340,1.60%
18155,Indiana,Switzerland County,10424,5327,5097,5215,5010,5148,4962,10110,314,No,3.01%,58,1%,146,1.40%
18157,Indiana,Tippecanoe County,177513,90490,87023,77691,76063,70998,70047,141045,36468,No,20.54%,8109,5%,13890,7.82%
18159,Indiana,Tipton County,15695,7807,7888,7657,7747,7463,7585,15048,647,No,4.12%,54,0%,386,2.46%
18161,Indiana,Union County,7362,3632,3730,3553,3634,3516,3590,7106,256,No,3.48%,41,1%,88,1.20%
18163,Indiana,Vanderburgh County,180858,87431,93427,76079,81215,74197,79538,153735,27123,No,15.00%,16650,9%,4269,2.36%
18165,Indiana,Vermillion County,16040,7937,8103,7805,7972,7728,7911,15639,401,No,2.50%,44,0%,160,1.00%
18167,Indiana,Vigo County,108428,54913,53515,47797,48144,46269,47332,93601,14827,No,13.67%,7701,7%,2671,2.46%
18169,Indiana,Wabash County,32361,15728,16633,15252,16142,14913,15837,30750,1611,No,4.98%,205,1%,710,2.19%
18171,Indiana,Warren County,8342,4194,4148,4121,4084,4066,4048,8114,228,No,2.73%,17,0%,96,1.15%
18173,Indiana,Warrick County,60463,29822,30641,28362,29275,27934,28841,56775,3688,No,6.10%,831,1%,981,1.62%
18175,Indiana,Washington County,27921,13946,13975,13719,13728,13552,13584,27136,785,No,2.81%,87,0%,352,1.26%
18177,Indiana,Wayne County,68346,33143,35203,30072,32190,29239,31484,60723,7623,No,11.15%,3455,5%,1854,2.71%
18179,Indiana,Wells County,27652,13616,14036,13318,13749,13004,13487,26491,1161,No,4.20%,143,1%,642,2.32%
18181,Indiana,White County,24426,12121,12305,11785,11962,10925,11227,22152,2274,No,9.31%,164,1%,1775,7.27%
18183,Indiana,Whitley County,33342,16611,16731,16228,16347,15979,16121,32100,1242,No,3.73%,123,0%,551,1.65%
19001,Iowa,Adair County,7481,3716,3765,3663,3715,3627,3671,7298,183,No,2.45%,16,0%,94,1.26%
19003,Iowa,Adams County,3911,1944,1967,1904,1930,1883,1916,3799,112,No,2.86%,11,0%,39,1.00%
19005,Iowa,Allamakee County,14237,7277,6960,7020,6708,6646,6413,13059,1178,No,8.27%,171,1%,857,6.02%
19007,Iowa,Appanoose County,12700,6214,6486,6074,6335,5986,6246,12232,468,No,3.69%,70,1%,199,1.57%
19009,Iowa,Audubon County,5910,2842,3068,2793,3015,2778,2992,5770,140,No,2.37%,21,0%,50,0.85%
19011,Iowa,Benton County,25827,12860,12967,12615,12732,12471,12592,25063,764,No,2.96%,114,0%,317,1.23%
19013,Iowa,Black Hawk County,131820,64305,67515,56038,58580,53759,56457,110216,21604,No,16.39%,11611,9%,5177,3.93%
19015,Iowa,Boone County,26195,13159,13036,12777,12721,12507,12486,24993,1202,No,4.59%,222,1%,564,2.15%
19017,Iowa,Bremer County,24479,11999,12480,11660,12135,11533,12013,23546,933,No,3.81%,213,1%,295,1.21%
19019,Iowa,Buchanan County,20942,10403,10539,10191,10337,10060,10221,20281,661,No,3.16%,81,0%,281,1.34%
19021,Iowa,Buena Vista County,20592,10430,10162,9137,9040,6575,6835,13410,7182,No,34.88%,547,3%,5048,24.51%
19023,Iowa,Butler County,14986,7393,7593,7267,7480,7196,7407,14603,383,No,2.56%,41,0%,158,1.05%
19025,Iowa,Calhoun County,9909,5089,4820,4849,4748,4769,4685,9454,455,No,4.59%,183,2%,155,1.56%
19027,Iowa,Carroll County,20631,10049,10582,9811,10365,9630,10199,19829,802,No,3.89%,128,1%,392,1.90%
19029,Iowa,Cass County,13723,6732,6991,6576,6851,6435,6736,13171,552,No,4.02%,50,0%,310,2.26%
19031,Iowa,Cedar County,18416,9104,9312,8878,9120,8731,8984,17715,701,No,3.81%,87,0%,318,1.73%
19033,Iowa,Cerro Gordo County,43788,21397,22391,20430,21626,19524,20901,40425,3363,No,7.68%,544,1%,1764,4.03%
19035,Iowa,Cherokee County,11946,5923,6023,5748,5874,5588,5739,11327,619,No,5.18%,78,1%,335,2.80%
19037,Iowa,Chickasaw County,12276,6189,6087,6104,5992,5960,5865,11825,451,No,3.67%,56,0%,299,2.44%
19039,Iowa,Clarke County,9370,4679,4691,4543,4558,4050,4111,8161,1209,No,12.90%,65,1%,1021,10.90%
19041,Iowa,Clay County,16599,8157,8442,7929,8257,7671,8052,15723,876,No,5.28%,92,1%,494,2.98%
19043,Iowa,Clayton County,17835,8915,8920,8766,8766,8608,8622,17230,605,No,3.39%,87,0%,327,1.83%
19045,Iowa,Clinton County,48717,23992,24725,22646,23418,21999,22886,44885,3832,No,7.87%,1418,3%,1360,2.79%
19047,Iowa,Crawford County,17309,8789,8520,8312,8155,6011,6139,12150,5159,No,29.81%,319,2%,4612,26.65%
19049,Iowa,Dallas County,71967,35267,36700,33012,34428,30820,32453,63273,8694,No,12.08%,1170,2%,4491,6.24%
19051,Iowa,Davis County,8689,4325,4364,4250,4300,4206,4259,8465,224,No,2.58%,15,0%,93,1.07%
19053,Iowa,Decatur County,8253,4130,4123,3913,3967,3810,3887,7697,556,No,6.74%,163,2%,220,2.67%
19055,Iowa,Delaware County,17574,8799,8775,8678,8645,8592,8583,17175,399,No,2.27%,60,0%,174,0.99%
19057,Iowa,Des Moines County,40340,19720,20620,17912,18894,17417,18446,35863,4477,No,11.10%,2189,5%,1124,2.79%
19059,Iowa,Dickinson County,16972,8419,8553,8284,8412,8173,8299,16472,500,No,2.95%,39,0%,244,1.44%
19061,Iowa,Dubuque County,95097,46954,48143,44222,45615,43331,44805,88136,6961,No,7.32%,2525,3%,1968,2.07%
19063,Iowa,Emmet County,10120,5101,5019,4796,4816,4436,4484,8920,1200,No,11.86%,80,1%,932,9.21%
19065,Iowa,Fayette County,20793,10365,10428,9993,10164,9784,9977,19761,1032,No,4.96%,240,1%,430,2.07%
19067,Iowa,Floyd County,16056,7899,8157,7608,7839,7466,7685,15151,905,No,5.64%,217,1%,347,2.16%
19069,Iowa,Franklin County,10554,5282,5272,5143,5142,4532,4674,9206,1348,No,12.77%,73,1%,1180,11.18%
19071,Iowa,Fremont County,7147,3568,3579,3480,3507,3408,3423,6831,316,No,4.42%,49,1%,175,2.45%
19073,Iowa,Greene County,9153,4490,4663,4393,4562,4279,4466,8745,408,No,4.46%,46,1%,235,2.57%
19075,Iowa,Grundy County,12448,6122,6326,6031,6244,5962,6184,12146,302,No,2.43%,37,0%,136,1.09%
19077,Iowa,Guthrie County,10777,5403,5374,5306,5275,5186,5193,10379,398,No,3.69%,20,0%,214,1.99%
19079,Iowa,Hamilton County,15344,7627,7717,7282,7383,6910,7052,13962,1382,No,9.01%,82,1%,807,5.26%
19081,Iowa,Hancock County,11134,5589,5545,5473,5417,5264,5253,10517,617,No,5.54%,58,1%,392,3.52%
19083,Iowa,Hardin County,17302,8579,8723,8216,8556,7882,8299,16181,1121,No,6.48%,215,1%,648,3.75%
19085,Iowa,Harrison County,14548,7241,7307,7110,7185,7023,7088,14111,437,No,3.00%,40,0%,199,1.37%
19087,Iowa,Henry County,20236,10369,9867,9506,9249,9075,8902,17977,2259,No,11.16%,515,3%,872,4.31%
19089,Iowa,Howard County,9563,4751,4812,4678,4738,4608,4688,9296,267,No,2.79%,28,0%,133,1.39%
19091,Iowa,Humboldt County,9729,4793,4936,4675,4843,4504,4675,9179,550,No,5.65%,59,1%,369,3.79%
19095,Iowa,Iowa County,16189,8029,8160,7874,8013,7729,7870,15599,590,No,3.64%,84,1%,330,2.04%
19097,Iowa,Jackson County,19712,9826,9886,9561,9627,9446,9518,18964,748,No,3.79%,108,1%,258,1.31%
19099,Iowa,Jasper County,36602,18660,17942,17909,17550,17621,17324,34945,1657,No,4.53%,521,1%,559,1.53%
19101,Iowa,Jefferson County,16867,8980,7887,7458,7373,7257,7178,14435,2432,No,14.42%,242,1%,471,2.79%
19103,Iowa,Johnson County,136317,68167,68150,59186,59236,55941,56327,112268,24049,No,17.64%,6991,5%,7005,5.14%
19105,Iowa,Jones County,20639,10812,9827,10224,9648,10054,9557,19611,1028,No,4.98%,510,2%,284,1.38%
19107,Iowa,Keokuk County,10374,5156,5218,5075,5136,4999,5087,10086,288,No,2.78%,51,0%,137,1.32%
19109,Iowa,Kossuth County,15346,7658,7688,7502,7541,7407,7435,14842,504,No,3.28%,65,0%,258,1.68%
19113,Iowa,Linn County,215295,106185,109110,96487,99738,93664,97248,190912,24383,No,11.33%,9008,4%,6216,2.89%
19115,Iowa,Louisa County,11278,5758,5520,5475,5345,4535,4509,9044,2234,No,19.81%,82,1%,1850,16.40%
19117,Iowa,Lucas County,8760,4397,4363,4337,4303,4290,4271,8561,199,No,2.27%,22,0%,93,1.06%
19119,Iowa,Lyon County,11757,5886,5871,5817,5795,5687,5677,11364,393,No,3.34%,25,0%,269,2.29%
19121,Iowa,Madison County,15654,7796,7858,7632,7710,7537,7620,15157,497,No,3.17%,65,0%,215,1.37%
19123,Iowa,Mahaska County,22443,11277,11166,10782,10827,10600,10657,21257,1186,No,5.28%,251,1%,405,1.80%
19125,Iowa,Marion County,33419,16633,16786,16038,16265,15807,15983,31790,1629,No,4.87%,281,1%,584,1.75%
19127,Iowa,Marshall County,40857,20524,20333,19065,19173,15327,15762,31089,9768,No,23.91%,804,2%,7551,18.48%
19129,Iowa,Mills County,14837,7435,7402,7247,7233,7059,7048,14107,730,No,4.92%,70,0%,394,2.66%
19131,Iowa,Mitchell County,10725,5278,5447,5225,5370,5172,5305,10477,248,No,2.31%,29,0%,133,1.24%
19133,Iowa,Monona County,9124,4486,4638,4359,4489,4302,4431,8733,391,No,4.29%,28,0%,132,1.45%
19135,Iowa,Monroe County,8063,4022,4041,3941,3933,3872,3835,7707,356,No,4.42%,39,0%,193,2.39%
19137,Iowa,Montgomery County,10566,5159,5407,5049,5315,4860,5187,10047,519,No,4.91%,28,0%,332,3.14%
19139,Iowa,Muscatine County,42879,21345,21534,20295,20507,16878,17247,34125,8754,No,20.42%,868,2%,7067,16.48%
19141,Iowa,O'Brien County,14172,7061,7111,6867,6935,6601,6725,13326,846,No,5.97%,122,1%,554,3.91%
19143,Iowa,Osceola County,6193,3124,3069,3053,3009,2852,2864,5716,477,No,7.70%,25,0%,375,6.06%
19145,Iowa,Page County,15713,8155,7558,7592,7305,7352,7127,14479,1234,No,7.85%,374,2%,470,2.99%
19147,Iowa,Palo Alto County,9275,4622,4653,4532,4535,4443,4458,8901,374,No,4.03%,51,1%,184,1.98%
19149,Iowa,Plymouth County,24907,12329,12578,12026,12296,11641,11933,23574,1333,No,5.35%,111,0%,821,3.30%
19151,Iowa,Pocahontas County,7150,3557,3593,3472,3508,3372,3421,6793,357,No,4.99%,45,1%,220,3.08%
19153,Iowa,Polk County,443710,217806,225904,189331,197373,172885,182475,355360,88350,No,19.91%,28220,6%,34887,7.86%
19155,Iowa,Pottawattamie County,92913,45577,47336,43493,45349,40444,42631,83075,9838,No,10.59%,1378,1%,6342,6.83%
19157,Iowa,Poweshiek County,18736,9196,9540,8808,9095,8592,8901,17493,1243,No,6.63%,224,1%,486,2.59%
19159,Iowa,Ringgold County,5096,2529,2567,2473,2519,2432,2479,4911,185,No,3.63%,22,0%,93,1.82%
19163,Iowa,Scott County,168799,82702,86097,72376,75291,67763,71171,138934,29865,No,17.69%,12269,7%,10072,5.97%
19165,Iowa,Shelby County,12069,5923,6146,5802,6055,5679,5945,11624,445,No,3.69%,39,0%,253,2.10%
19167,Iowa,Sioux County,34268,17142,17126,16702,16684,15083,15349,30432,3836,No,11.19%,196,1%,3168,9.24%
19169,Iowa,Story County,91140,47208,43932,41782,39432,40454,38333,78787,12353,No,13.55%,2529,3%,2862,3.14%
19171,Iowa,Tama County,17536,8602,8934,7658,7940,7169,7489,14658,2878,No,16.41%,105,1%,1378,7.86%
19173,Iowa,Taylor County,6208,3107,3101,3051,3047,2815,2861,5676,532,No,8.57%,28,0%,441,7.10%
19175,Iowa,Union County,12594,6074,6520,5901,6351,5773,6251,12024,570,No,4.53%,106,1%,273,2.17%
19177,Iowa,Van Buren County,7449,3759,3690,3699,3635,3661,3591,7252,197,No,2.64%,14,0%,88,1.18%
19179,Iowa,Wapello County,35366,17371,17995,16506,17108,14936,15674,30610,4756,No,13.45%,614,2%,3359,9.50%
19181,Iowa,Warren County,46891,22890,24001,22283,23432,21850,22984,44834,2057,No,4.39%,278,1%,959,2.05%
19183,Iowa,Washington County,21914,10740,11174,10440,10870,9873,10338,20211,1703,No,7.77%,179,1%,1177,5.37%
19185,Iowa,Wayne County,6344,3080,3264,3027,3188,2984,3155,6139,205,No,3.23%,27,0%,87,1.37%
19187,Iowa,Webster County,37273,19167,18106,17617,17104,16861,16480,33341,3932,No,10.55%,1535,4%,1532,4.11%
19189,Iowa,Winnebago County,10600,5179,5421,5015,5271,4845,5119,9964,636,No,6.00%,101,1%,353,3.33%
19191,Iowa,Winneshiek County,21061,10427,10634,10123,10346,9917,10180,20097,964,No,4.58%,162,1%,425,2.02%
19193,Iowa,Woodbury County,102323,50628,51695,45151,46544,38454,40350,78804,23519,No,22.99%,2705,3%,14517,14.19%
19195,Iowa,Worth County,7519,3727,3792,3650,3716,3572,3647,7219,300,No,3.99%,40,1%,171,2.27%
19197,Iowa,Wright County,12991,6499,6492,6340,6325,5688,5822,11510,1481,No,11.40%,74,1%,1227,9.45%
20001,Kansas,Allen County,13319,6514,6805,6113,6382,5935,6233,12168,1151,No,8.64%,288,2%,398,2.99%
20003,Kansas,Anderson County,7917,3923,3994,3791,3857,3731,3791,7522,395,No,4.99%,51,1%,133,1.68%
20005,Kansas,Atchison County,16813,8193,8620,7440,7900,7236,7724,14960,1853,No,11.02%,870,5%,429,2.55%
20007,Kansas,Barber County,4861,2472,2389,2391,2311,2332,2256,4588,273,No,5.62%,32,1%,131,2.69%
20009,Kansas,Barton County,27557,13588,13969,12974,13375,11134,11721,22855,4702,No,17.06%,465,2%,3800,13.79%
20011,Kansas,Bourbon County,14897,7353,7544,6783,7087,6661,6961,13622,1275,No,8.56%,459,3%,329,2.21%
20013,Kansas,Brown County,9881,4842,5039,4154,4339,4059,4228,8287,1594,No,16.13%,147,1%,344,3.48%
20015,Kansas,Butler County,65827,33158,32669,30960,31051,29668,29991,59659,6168,No,9.37%,1183,2%,2691,4.09%
20017,Kansas,Chase County,2757,1409,1348,1334,1315,1275,1281,2556,201,No,7.29%,37,1%,100,3.63%
20019,Kansas,Chautauqua County,3571,1839,1732,1653,1559,1618,1524,3142,429,No,12.01%,33,1%,101,2.83%
20021,Kansas,Cherokee County,21226,10492,10734,9487,9768,9308,9573,18881,2345,No,11.05%,145,1%,453,2.13%
20023,Kansas,Cheyenne County,2678,1342,1336,1327,1304,1247,1234,2481,197,No,7.36%,5,0%,153,5.71%
20025,Kansas,Clark County,2181,1060,1121,1008,1067,911,986,1897,284,No,13.02%,13,1%,183,8.39%
20027,Kansas,Clay County,8531,4223,4308,4101,4194,3998,4107,8105,426,No,4.99%,53,1%,210,2.46%
20029,Kansas,Cloud County,9397,4590,4807,4446,4661,4306,4545,8851,546,No,5.81%,72,1%,292,3.11%
20031,Kansas,Coffey County,8502,4206,4296,4064,4137,3981,4054,8035,467,No,5.49%,57,1%,189,2.22%
20033,Kansas,Comanche County,1913,910,1003,892,976,849,934,1783,130,No,6.80%,8,0%,88,4.60%
20035,Kansas,Cowley County,36288,18135,18153,16171,16430,14533,14977,29510,6778,No,18.68%,1052,3%,3551,9.79%
20037,Kansas,Crawford County,39361,19607,19754,18074,18332,17157,17564,34721,4640,No,11.79%,853,2%,1948,4.95%
20039,Kansas,Decatur County,2871,1445,1426,1417,1388,1381,1370,2751,120,No,4.18%,17,1%,55,1.92%
20041,Kansas,Dickinson County,19762,9816,9946,9371,9533,8995,9176,18171,1591,No,8.05%,223,1%,867,4.39%
20043,Kansas,Doniphan County,7864,3974,3890,3650,3653,3563,3575,7138,726,No,9.23%,253,3%,188,2.39%
20045,Kansas,Douglas County,112864,56460,56404,47953,48125,45481,45777,91258,21606,No,19.14%,4927,4%,6164,5.46%
20047,Kansas,Edwards County,2979,1501,1478,1434,1403,1185,1154,2339,640,No,21.48%,46,2%,571,19.17%
20049,Kansas,Elk County,2720,1343,1377,1277,1304,1239,1268,2507,213,No,7.83%,3,0%,89,3.27%
20051,Kansas,Ellis County,29053,14510,14543,13869,13922,13120,13305,26425,2628,No,9.05%,330,1%,1495,5.15%
20053,Kansas,Ellsworth County,6494,3664,2830,3255,2735,3014,2622,5636,858,No,13.21%,315,5%,374,5.76%
20055,Kansas,Finney County,37200,18713,18487,16864,16757,8126,8581,16707,20493,Yes,55.09%,1091,3%,17760,47.74%
20057,Kansas,Ford County,34752,17991,16761,16523,15353,7333,7348,14681,20071,Yes,57.75%,1025,3%,18120,52.14%
20059,Kansas,Franklin County,25906,12877,13029,12165,12392,11751,12005,23756,2150,No,8.30%,371,1%,978,3.78%
20061,Kansas,Geary County,38013,19513,18500,13910,12914,11779,10986,22765,15248,No,40.11%,7005,18%,5244,13.80%
20063,Kansas,Gove County,2729,1357,1372,1328,1351,1304,1328,2632,97,No,3.55%,12,0%,54,1.98%
20065,Kansas,Graham County,2578,1262,1316,1146,1213,1128,1193,2321,257,No,9.97%,107,4%,65,2.52%
20067,Kansas,Grant County,7923,4045,3878,3859,3708,2062,2141,4203,3720,No,46.95%,64,1%,3565,45.00%
20069,Kansas,Gray County,6030,2987,3043,2913,2960,2486,2550,5036,994,No,16.48%,43,1%,878,14.56%
20071,Kansas,Greeley County,1298,633,665,618,649,533,551,1084,214,No,16.49%,6,0%,191,14.71%
20073,Kansas,Greenwood County,6454,3194,3260,3060,3120,2948,3029,5977,477,No,7.39%,26,0%,244,3.78%
20075,Kansas,Hamilton County,2639,1342,1297,1269,1252,869,867,1736,903,No,34.22%,12,0%,836,31.68%
20077,Kansas,Harper County,5911,2954,2957,2836,2849,2663,2709,5372,539,No,9.12%,32,1%,364,6.16%
20079,Kansas,Harvey County,34852,17106,17746,16058,16803,14257,15109,29366,5486,No,15.74%,619,2%,3819,10.96%
20081,Kansas,Haskell County,4256,2112,2144,2032,2051,1439,1517,2956,1300,No,30.55%,26,1%,1203,28.27%
20083,Kansas,Hodgeman County,1963,998,965,973,934,905,885,1790,173,No,8.81%,19,1%,117,5.96%
20085,Kansas,Jackson County,13449,6754,6695,5901,5853,5745,5695,11440,2009,No,14.94%,92,1%,510,3.79%
20087,Kansas,Jefferson County,18945,9641,9304,9268,8978,9056,8822,17878,1067,No,5.63%,122,1%,418,2.21%
20089,Kansas,Jewell County,3046,1561,1485,1519,1457,1491,1425,2916,130,No,4.27%,10,0%,65,2.13%
20091,Kansas,Johnson County,559913,273620,286293,240348,251804,221278,233643,454921,104992,No,18.75%,26976,5%,41349,7.38%
20093,Kansas,Kearny County,3968,2003,1965,1918,1884,1336,1343,2679,1289,No,32.48%,32,1%,1155,29.11%
20095,Kansas,Kingman County,7863,3918,3945,3801,3822,3698,3733,7431,432,No,5.49%,18,0%,214,2.72%
20097,Kansas,Kiowa County,2496,1246,1250,1200,1200,1137,1152,2289,207,No,8.29%,20,1%,120,4.81%
20099,Kansas,Labette County,21284,10541,10743,9297,9526,8930,9173,18103,3181,No,14.95%,994,5%,900,4.23%
20101,Kansas,Lane County,1704,839,865,804,830,780,791,1571,133,No,7.81%,12,1%,82,4.81%
20103,Kansas,Leavenworth County,77739,41377,36362,34493,31734,31965,30014,61979,15760,No,20.27%,7407,10%,4975,6.40%
20105,Kansas,Lincoln County,3174,1583,1591,1542,1560,1505,1521,3026,148,No,4.66%,12,0%,78,2.46%
20107,Kansas,Linn County,9441,4714,4727,4564,4579,4465,4486,8951,490,No,5.19%,57,1%,201,2.13%
20109,Kansas,Logan County,2784,1416,1368,1355,1321,1307,1274,2581,203,No,7.29%,22,1%,107,3.84%
20111,Kansas,Lyon County,33748,16454,17294,14944,15710,11711,12709,24420,9328,No,27.64%,954,3%,6895,20.43%
20113,Kansas,McPherson County,29356,14394,14962,13744,14380,13262,13918,27180,2176,No,7.41%,349,1%,1090,3.71%
20115,Kansas,Marion County,12347,6175,6172,5946,5971,5812,5823,11635,712,No,5.77%,117,1%,330,2.67%
20117,Kansas,Marshall County,10022,4977,5045,4853,4922,4753,4846,9599,423,No,4.22%,34,0%,195,1.95%
20119,Kansas,Meade County,4396,2236,2160,2144,2093,1786,1775,3561,835,No,18.99%,38,1%,693,15.76%
20121,Kansas,Miami County,32612,16170,16442,15457,15765,15002,15366,30368,2244,No,6.88%,453,1%,947,2.90%
20123,Kansas,Mitchell County,6355,3242,3113,3178,3056,3111,3009,6120,235,No,3.70%,21,0%,124,1.95%
20125,Kansas,Montgomery County,34459,16874,17585,14268,15123,13470,14303,27773,6686,No,19.40%,2007,6%,1949,5.66%
20127,Kansas,Morris County,5854,2900,2954,2807,2859,2693,2758,5451,403,No,6.88%,37,1%,235,4.01%
20129,Kansas,Morton County,3169,1583,1586,1472,1492,1142,1225,2367,802,No,25.31%,23,1%,643,20.29%
20131,Kansas,Nemaha County,10132,5108,5024,4963,4870,4903,4817,9720,412,No,4.07%,60,1%,153,1.51%
20133,Kansas,Neosho County,16406,8110,8296,7681,7893,7336,7602,14938,1468,No,8.95%,205,1%,738,4.50%
20135,Kansas,Ness County,3068,1541,1527,1501,1485,1371,1374,2745,323,No,10.53%,18,1%,269,8.77%
20137,Kansas,Norton County,5612,3119,2493,2890,2428,2726,2356,5082,530,No,9.44%,170,3%,241,4.29%
20139,Kansas,Osage County,16142,8054,8088,7797,7816,7639,7642,15281,861,No,5.33%,63,0%,379,2.35%
20141,Kansas,Osborne County,3806,1913,1893,1870,1856,1841,1842,3683,123,No,3.23%,11,0%,53,1.39%
20143,Kansas,Ottawa County,6072,3170,2902,3064,2825,3000,2774,5774,298,No,4.91%,57,1%,135,2.22%
20145,Kansas,Pawnee County,6928,3835,3093,3455,2890,3196,2716,5912,1016,No,14.67%,342,5%,498,7.19%
20147,Kansas,Phillips County,5519,2736,2783,2657,2691,2606,2631,5237,282,No,5.11%,29,1%,138,2.50%
20149,Kansas,Pottawatomie County,22302,11101,11201,10475,10601,9975,10181,20156,2146,No,9.62%,281,1%,1095,4.91%
20151,Kansas,Pratt County,9728,4838,4890,4601,4666,4340,4392,8732,996,No,10.24%,134,1%,613,6.30%
20153,Kansas,Rawlins County,2560,1270,1290,1240,1268,1197,1217,2414,146,No,5.70%,15,1%,100,3.91%
20155,Kansas,Reno County,64438,32353,32085,29721,30377,27084,28058,55142,9296,No,14.43%,2079,3%,5490,8.52%
20157,Kansas,Republic County,4858,2380,2478,2331,2433,2307,2412,4719,139,No,2.86%,29,1%,64,1.32%
20159,Kansas,Rice County,9985,5004,4981,4729,4731,4232,4286,8518,1467,No,14.69%,147,1%,1054,10.56%
20161,Kansas,Riley County,75508,39966,35542,33681,30225,31058,28124,59182,16326,No,21.62%,5268,7%,5607,7.43%
20163,Kansas,Rooks County,5223,2567,2656,2510,2585,2462,2547,5009,214,No,4.10%,27,1%,105,2.01%
20165,Kansas,Rush County,3220,1612,1608,1574,1568,1525,1523,3048,172,No,5.34%,12,0%,103,3.20%
20167,Kansas,Russell County,6946,3440,3506,3309,3373,3238,3313,6551,395,No,5.69%,60,1%,152,2.19%
20169,Kansas,Saline County,55988,27846,28142,25082,25624,22389,23170,45559,10429,No,18.63%,1956,3%,5757,10.28%
20171,Kansas,Scott County,4937,2506,2431,2440,2361,2021,2010,4031,906,No,18.35%,22,0%,813,16.47%
20173,Kansas,Sedgwick County,503889,249350,254539,203000,206319,172520,177705,350225,153664,No,30.50%,47938,10%,67595,13.41%
20175,Kansas,Seward County,23547,12149,11398,10846,10226,3961,4106,8067,15480,Yes,65.74%,957,4%,13637,57.91%
20177,Kansas,Shawnee County,178991,86766,92225,73355,78189,64819,69909,134728,44263,No,24.73%,15670,9%,20244,11.31%
20179,Kansas,Sheridan County,2538,1293,1245,1272,1220,1236,1188,2424,114,No,4.49%,3,0%,80,3.15%
20181,Kansas,Sherman County,6113,3082,3031,2970,2893,2628,2565,5193,920,No,15.05%,54,1%,719,11.76%
20183,Kansas,Smith County,3765,1849,1916,1803,1864,1778,1832,3610,155,No,4.12%,13,0%,61,1.62%
20185,Kansas,Stafford County,4358,2182,2176,2094,2071,1803,1858,3661,697,No,15.99%,22,1%,580,13.31%
20187,Kansas,Stanton County,2175,1123,1052,1075,1007,662,655,1317,858,No,39.45%,18,1%,800,36.78%
20189,Kansas,Stevens County,5756,2837,2919,2730,2813,1819,1927,3746,2010,No,34.92%,34,1%,1872,32.52%
20191,Kansas,Sumner County,23674,11857,11817,11306,11219,10774,10736,21510,2164,No,9.14%,266,1%,1172,4.95%
20193,Kansas,Thomas County,7941,3895,4046,3746,3907,3560,3746,7306,635,No,8.00%,62,1%,397,5.00%
20195,Kansas,Trego County,2986,1470,1516,1436,1482,1414,1455,2869,117,No,3.92%,16,1%,56,1.88%
20197,Kansas,Wabaunsee County,7039,3596,3443,3464,3319,3372,3229,6601,438,No,6.22%,46,1%,222,3.15%
20199,Kansas,Wallace County,1517,760,757,744,731,692,687,1379,138,No,9.10%,9,1%,114,7.51%
20201,Kansas,Washington County,5758,2901,2857,2834,2781,2753,2721,5474,284,No,4.93%,32,1%,167,2.90%
20203,Kansas,Wichita County,2256,1177,1079,1142,1050,812,796,1608,648,No,28.72%,24,1%,607,26.91%
20205,Kansas,Wilson County,9105,4460,4645,4272,4433,4158,4344,8502,603,No,6.62%,42,0%,250,2.75%
20207,Kansas,Woodson County,3278,1637,1641,1561,1584,1529,1555,3084,194,No,5.92%,15,0%,81,2.47%
20209,Kansas,Wyandotte County,159129,78557,80572,53774,52895,33480,34750,68230,90899,Yes,57.12%,40412,25%,42811,26.90%
21001,Kentucky,Adair County,18675,9220,9455,8784,9063,8612,8936,17548,1127,No,6.03%,506,3%,348,1.86%
21003,Kentucky,Allen County,20210,9954,10256,9679,9994,9526,9859,19385,825,No,4.08%,204,1%,321,1.59%
21005,Kentucky,Anderson County,21728,10651,11077,10218,10610,10057,10500,20557,1171,No,5.39%,463,2%,306,1.41%
21007,Kentucky,Ballard County,8333,4154,4179,3941,3970,3890,3925,7815,518,No,6.22%,239,3%,107,1.28%
21009,Kentucky,Barren County,42631,20740,21891,19314,20502,18773,20126,38899,3732,No,8.75%,1730,4%,1176,2.76%
21011,Kentucky,Bath County,11802,5846,5956,5674,5772,5595,5711,11306,496,No,4.20%,170,1%,169,1.43%
21013,Kentucky,Bell County,28183,13759,14424,13073,13837,12972,13708,26680,1503,No,5.33%,656,2%,269,0.95%
21015,Kentucky,Boone County,123316,61086,62230,56494,57767,54362,55799,110161,13155,No,10.67%,3558,3%,4570,3.71%
21017,Kentucky,Bourbon County,19978,9733,10245,8891,9366,8095,8890,16985,2993,No,14.98%,1221,6%,1402,7.02%
21019,Kentucky,Boyd County,49164,24476,24688,22853,23861,22469,23618,46087,3077,No,6.26%,1435,3%,733,1.49%
21021,Kentucky,Boyle County,28658,13976,14682,12401,13239,11993,12898,24891,3767,No,13.14%,2116,7%,877,3.06%
21023,Kentucky,Bracken County,8494,4244,4250,4164,4169,4114,4124,8238,256,No,3.01%,43,1%,108,1.27%
21025,Kentucky,Breathitt County,13635,6836,6799,6696,6698,6655,6645,13300,335,No,2.46%,57,0%,104,0.76%
21027,Kentucky,Breckinridge County,20071,10031,10040,9629,9619,9512,9529,19041,1030,No,5.13%,448,2%,239,1.19%
21029,Kentucky,Bullitt County,75896,37616,38280,36475,37174,35958,36685,72643,3253,No,4.29%,657,1%,1121,1.48%
21031,Kentucky,Butler County,12840,6414,6426,6269,6289,6070,6128,12198,642,No,5.00%,73,1%,420,3.27%
21033,Kentucky,Caldwell County,12935,6280,6655,5816,6178,5725,6119,11844,1091,No,8.43%,697,5%,167,1.29%
21035,Kentucky,Calloway County,37655,18120,19535,16666,18149,16238,17756,33994,3661,No,9.72%,1463,4%,941,2.50%
21037,Kentucky,Campbell County,90908,44702,46206,42274,43810,41568,43231,84799,6109,No,6.72%,2434,3%,1549,1.70%
21039,Kentucky,Carlisle County,5034,2444,2590,2361,2515,2313,2478,4791,243,No,4.83%,51,1%,102,2.03%
21041,Kentucky,Carroll County,10900,5480,5420,5222,5186,4815,4890,9705,1195,No,10.96%,186,2%,728,6.68%
21043,Kentucky,Carter County,27348,13537,13811,13252,13558,13079,13411,26490,858,No,3.14%,167,1%,361,1.32%
21045,Kentucky,Casey County,16082,7879,8203,7721,8012,7507,7845,15352,730,No,4.54%,117,1%,433,2.69%
21047,Kentucky,Christian County,75427,39202,36225,28999,26140,26601,24414,51015,24412,No,32.37%,16197,21%,5215,6.91%
21049,Kentucky,Clark County,35787,17453,18334,16218,17024,15726,16689,32415,3372,No,9.42%,1822,5%,940,2.63%
21051,Kentucky,Clay County,21556,11546,10010,10588,9767,10286,9702,19988,1568,No,7.27%,945,4%,403,1.87%
21053,Kentucky,Clinton County,10285,5091,5194,4953,5071,4827,4986,9813,472,No,4.59%,51,0%,274,2.66%
21055,Kentucky,Crittenden County,9280,4676,4604,4549,4518,4505,4498,9003,277,No,2.98%,76,1%,69,0.74%
21057,Kentucky,Cumberland County,6819,3358,3461,3191,3328,3163,3291,6454,365,No,5.35%,191,3%,70,1.03%
21059,Kentucky,Daviess County,97847,47533,50314,43662,46553,42351,45537,87888,9959,No,10.18%,4827,5%,2633,2.69%
21061,Kentucky,Edmonson County,12071,6055,6016,5827,5875,5770,5819,11589,482,No,3.99%,189,2%,124,1.03%
21063,Kentucky,Elliott County,7780,4377,3403,4071,3374,4042,3358,7400,380,No,4.88%,269,3%,61,0.78%
21065,Kentucky,Estill County,14493,7162,7331,7062,7232,7005,7188,14193,300,No,2.07%,37,0%,119,0.82%
21067,Kentucky,Fayette County,305489,150411,155078,118697,121917,108116,113886,222002,83487,No,27.33%,45486,15%,21319,6.98%
21069,Kentucky,Fleming County,14560,7169,7391,6983,7186,6889,7141,14030,530,No,3.64%,203,1%,179,1.23%
21071,Kentucky,Floyd County,38949,19002,19947,18682,19587,18563,19467,38030,919,No,2.36%,328,1%,268,0.69%
21073,Kentucky,Franklin County,49804,24117,25687,20305,21890,19677,21368,41045,8759,No,17.59%,5574,11%,1410,2.83%
21075,Kentucky,Fulton County,6525,3258,3267,2345,2348,2319,2311,4630,1895,No,29.04%,1637,25%,82,1.26%
21077,Kentucky,Gallatin County,8479,4305,4174,4135,4021,3912,3883,7795,684,No,8.07%,122,1%,409,4.82%
21079,Kentucky,Garrard County,16913,8327,8586,8002,8296,7795,8144,15939,974,No,5.76%,379,2%,403,2.38%
21081,Kentucky,Grant County,24485,12274,12211,11905,11916,11613,11656,23269,1216,No,4.97%,213,1%,596,2.43%
21083,Kentucky,Graves County,37544,18505,19039,17103,17740,15956,16811,32767,4777,No,12.72%,1761,5%,2239,5.96%
21085,Kentucky,Grayson County,25964,13090,12874,12683,12607,12543,12485,25028,936,No,3.60%,283,1%,304,1.17%
21087,Kentucky,Green County,11315,5626,5689,5392,5475,5301,5416,10717,598,No,5.29%,237,2%,183,1.62%
21089,Kentucky,Greenup County,36707,17773,18934,17224,18452,17060,18320,35380,1327,No,3.62%,316,1%,358,0.98%
21091,Kentucky,Hancock County,8677,4420,4257,4298,4157,4245,4113,8358,319,No,3.68%,88,1%,113,1.30%
21093,Kentucky,Hardin County,107025,53338,53687,43221,43522,40869,41423,82292,24733,No,23.11%,13514,13%,5681,5.31%
21095,Kentucky,Harlan County,28543,13919,14624,13357,14091,13250,13999,27249,1294,No,4.53%,644,2%,232,0.81%
21097,Kentucky,Harrison County,18624,9127,9497,8758,9150,8533,9029,17562,1062,No,5.70%,382,2%,370,1.99%
21099,Kentucky,Hart County,18366,9067,9299,8465,8709,8313,8605,16918,1448,No,7.88%,866,5%,277,1.51%
21101,Kentucky,Henderson County,46513,22510,24003,20108,21542,19682,21156,40838,5675,No,12.20%,3732,8%,959,2.06%
21103,Kentucky,Henry County,15318,7587,7731,7171,7357,6891,7173,14064,1254,No,8.19%,437,3%,507,3.31%
21105,Kentucky,Hickman County,4754,2273,2481,1999,2199,1974,2175,4149,605,No,12.73%,456,10%,56,1.18%
21107,Kentucky,Hopkins County,46718,22841,23877,20681,21594,20301,21303,41604,5114,No,10.95%,3198,7%,793,1.70%
21109,Kentucky,Jackson County,13331,6650,6681,6577,6596,6527,6561,13088,243,No,1.82%,28,0%,99,0.74%
21111,Kentucky,Jefferson County,750828,362669,388159,270559,284281,254787,270863,525650,225178,No,29.99%,159807,21%,34702,4.62%
21113,Kentucky,Jessamine County,49635,24262,25373,22684,23763,21998,23227,45225,4410,No,8.88%,1607,3%,1346,2.71%
21115,Kentucky,Johnson County,23383,11506,11877,11291,11677,11230,11631,22861,522,No,2.23%,87,0%,123,0.53%
21117,Kentucky,Kenton County,161711,79986,81725,73299,75130,71198,73396,144594,17117,No,10.58%,7743,5%,4621,2.86%
21119,Kentucky,Knott County,16124,8033,8091,7878,7951,7832,7912,15744,380,No,2.36%,148,1%,115,0.71%
21121,Kentucky,Knox County,31735,15426,16309,14986,15905,14836,15765,30601,1134,No,3.57%,371,1%,326,1.03%
21123,Kentucky,Larue County,14151,7024,7127,6635,6791,6373,6637,13010,1141,No,8.06%,437,3%,439,3.10%
21125,Kentucky,Laurel County,59462,29131,30331,28336,29477,27960,29180,57140,2322,No,3.91%,472,1%,802,1.35%
21127,Kentucky,Lawrence County,15848,7910,7938,7793,7810,7749,7776,15525,323,No,2.04%,44,0%,97,0.61%
21129,Kentucky,Lee County,7706,4233,3473,4012,3404,3966,3394,7360,346,No,4.49%,188,2%,67,0.87%
21131,Kentucky,Leslie County,11170,5520,5650,5447,5582,5423,5563,10986,184,No,1.65%,35,0%,47,0.42%
21133,Kentucky,Letcher County,23952,11849,12103,11686,11953,11605,11883,23488,464,No,1.94%,111,0%,164,0.68%
21135,Kentucky,Lewis County,13835,6881,6954,6801,6860,6761,6810,13571,264,No,1.91%,47,0%,97,0.70%
21137,Kentucky,Lincoln County,24461,12049,12412,11555,11895,11377,11738,23115,1346,No,5.50%,590,2%,379,1.55%
21139,Kentucky,Livingston County,9423,4599,4824,4506,4723,4456,4667,9123,300,No,3.18%,36,0%,133,1.41%
21141,Kentucky,Logan County,26646,13069,13577,11836,12332,11516,12108,23624,3022,No,11.34%,1862,7%,682,2.56%
21143,Kentucky,Lyon County,8351,4623,3728,4172,3604,4107,3568,7675,676,No,8.09%,443,5%,113,1.35%
21145,Kentucky,McCracken County,65549,31406,34143,26969,29206,26318,28637,54955,10594,No,16.16%,7224,11%,1470,2.24%
21147,Kentucky,McCreary County,18069,9845,8224,8542,8029,8274,7978,16252,1817,No,10.06%,1067,6%,420,2.32%
21149,Kentucky,McLean County,9506,4698,4808,4610,4726,4552,4679,9231,275,No,2.89%,65,1%,117,1.23%
21151,Kentucky,Madison County,84786,41152,43634,37872,40235,37000,39503,76503,8283,No,9.77%,3836,5%,1900,2.24%
21153,Kentucky,Magoffin County,13041,6539,6502,6455,6409,6400,6368,12768,273,No,2.09%,30,0%,120,0.92%
21155,Kentucky,Marion County,20090,10392,9698,9183,8761,8911,8553,17464,2626,No,13.07%,1676,8%,527,2.62%
21157,Kentucky,Marshall County,31344,15386,15958,15138,15683,14981,15481,30462,882,No,2.81%,104,0%,390,1.24%
21159,Kentucky,Martin County,12743,7059,5684,6076,5620,5728,5590,11318,1425,No,11.18%,900,7%,402,3.15%
21161,Kentucky,Mason County,17512,8471,9041,7680,8194,7562,8100,15662,1850,No,10.56%,1167,7%,264,1.51%
21163,Kentucky,Meade County,29237,14608,14629,13450,13479,13027,13051,26078,3159,No,10.80%,1141,4%,1019,3.49%
21165,Kentucky,Menifee County,6220,3107,3113,2951,3044,2927,3024,5951,269,No,4.32%,138,2%,55,0.88%
21167,Kentucky,Mercer County,21261,10378,10883,9729,10187,9515,9994,19509,1752,No,8.24%,799,4%,508,2.39%
21169,Kentucky,Metcalfe County,9969,4921,5048,4766,4912,4706,4855,9561,408,No,4.09%,169,2%,138,1.38%
21171,Kentucky,Monroe County,10821,5384,5437,5191,5243,5015,5129,10144,677,No,6.26%,256,2%,304,2.81%
21173,Kentucky,Montgomery County,26902,13108,13794,12453,13190,12137,12928,25065,1837,No,6.83%,809,3%,713,2.65%
21175,Kentucky,Morgan County,13668,7758,5910,7038,5839,6973,5816,12789,879,No,6.43%,613,4%,106,0.78%
21177,Kentucky,Muhlenberg County,31181,15797,15384,14709,14611,14514,14453,28967,2214,No,7.10%,1428,5%,398,1.28%
21179,Kentucky,Nelson County,44319,21825,22494,20232,20823,19789,20454,40243,4076,No,9.20%,2287,5%,914,2.06%
21181,Kentucky,Nicholas County,7000,3458,3542,3392,3484,3307,3434,6741,259,No,3.70%,46,1%,138,1.97%
21183,Kentucky,Ohio County,24075,11989,12086,11669,11793,11225,11444,22669,1406,No,5.84%,238,1%,883,3.67%
21185,Kentucky,Oldham County,61412,32280,29132,29267,27349,28256,26550,54806,6606,No,10.76%,2758,4%,2118,3.45%
21187,Kentucky,Owen County,10765,5341,5424,5209,5310,5083,5189,10272,493,No,4.58%,102,1%,270,2.51%
21189,Kentucky,Owsley County,4722,2335,2387,2306,2344,2283,2326,4609,113,No,2.39%,24,1%,42,0.89%
21191,Kentucky,Pendleton County,14604,7330,7274,7200,7131,7141,7074,14215,389,No,2.66%,74,1%,144,0.99%
21193,Kentucky,Perry County,28241,13985,14256,13468,13823,13360,13738,27098,1143,No,4.05%,453,2%,212,0.75%
21195,Kentucky,Pike County,64178,31485,32693,30829,32106,30598,31913,62511,1667,No,2.60%,416,1%,458,0.71%
21197,Kentucky,Powell County,12483,6210,6273,6077,6164,5991,6114,12105,378,No,3.03%,99,1%,141,1.13%
21199,Kentucky,Pulaski County,63593,31094,32499,30109,31484,29366,30905,60271,3322,No,5.22%,798,1%,1441,2.27%
21201,Kentucky,Robertson County,2188,1124,1064,1099,1049,1095,1035,2130,58,No,2.65%,10,0%,24,1.10%
21203,Kentucky,Rockcastle County,17006,8366,8640,8227,8509,8167,8453,16620,386,No,2.27%,44,0%,127,0.75%
21205,Kentucky,Rowan County,23447,11407,12040,10958,11602,10804,11475,22279,1168,No,4.98%,411,2%,325,1.39%
21207,Kentucky,Russell County,17497,8526,8971,8313,8771,8000,8534,16534,963,No,5.50%,113,1%,600,3.43%
21209,Kentucky,Scott County,49057,24133,24924,21975,22835,20988,22049,43037,6020,No,12.27%,2781,6%,2009,4.10%
21211,Kentucky,Shelby County,43614,21020,22594,18719,20092,16808,18541,35349,8265,No,18.95%,3302,8%,3944,9.04%
21213,Kentucky,Simpson County,17538,8568,8970,7454,7852,7306,7733,15039,2499,No,14.25%,1728,10%,321,1.83%
21215,Kentucky,Spencer County,17416,8817,8599,8498,8279,8361,8156,16517,899,No,5.16%,288,2%,290,1.67%
21217,Kentucky,Taylor County,24691,11935,12756,10957,11894,10731,11693,22424,2267,No,9.18%,1267,5%,467,1.89%
21219,Kentucky,Todd County,12651,6229,6422,5621,5760,5343,5563,10906,1745,No,13.79%,1059,8%,510,4.03%
21221,Kentucky,Trigg County,14447,7085,7362,6347,6575,6241,6502,12743,1704,No,11.79%,1159,8%,209,1.45%
21223,Kentucky,Trimble County,8787,4449,4338,4310,4202,4216,4108,8324,463,No,5.27%,92,1%,269,3.06%
21225,Kentucky,Union County,14850,7580,7270,6280,6432,6123,6342,12465,2385,No,16.06%,1810,12%,272,1.83%
21227,Kentucky,Warren County,117110,57413,59697,48926,51053,46149,48793,94942,22168,No,18.93%,10805,9%,5709,4.87%
21229,Kentucky,Washington County,11833,5791,6042,5336,5540,5105,5348,10453,1380,No,11.66%,752,6%,443,3.74%
21231,Kentucky,Wayne County,20824,10308,10516,9909,10173,9629,9933,19562,1262,No,6.06%,347,2%,615,2.95%
21233,Kentucky,Webster County,13583,6736,6847,6245,6429,5951,6152,12103,1480,No,10.90%,590,4%,652,4.80%
21235,Kentucky,Whitley County,35499,17332,18167,16804,17729,16669,17566,34235,1264,No,3.56%,267,1%,352,0.99%
21237,Kentucky,Wolfe County,7164,3529,3635,3481,3597,3452,3578,7030,134,No,1.87%,16,0%,50,0.70%
21239,Kentucky,Woodford County,25077,12032,13045,11123,12019,10223,11355,21578,3499,No,13.95%,1354,5%,1679,6.70%
22001,Louisiana,Acadia Parish,61912,30188,31724,24197,25300,23624,24915,48539,13373,No,21.60%,11314,18%,1158,1.87%
22003,Louisiana,Allen Parish,25539,14387,11152,9927,8424,9787,8281,18068,7471,No,29.25%,5973,23%,382,1.50%
22005,Louisiana,Ascension Parish,112286,55381,56905,41847,41953,39203,39722,78925,33361,No,29.71%,25436,23%,5476,4.88%
22007,Louisiana,Assumption Parish,23026,11265,11761,7747,7945,7538,7782,15320,7706,No,33.47%,6904,30%,466,2.02%
22009,Louisiana,Avoyelles Parish,41632,20830,20802,13723,14272,13499,14051,27550,14082,No,33.82%,12228,29%,662,1.59%
22011,Louisiana,Beauregard Parish,36281,18516,17765,15084,14755,14633,14329,28962,7319,No,20.17%,4884,13%,1172,3.23%
22013,Louisiana,Bienville Parish,14076,6783,7293,3896,3992,3808,3913,7721,6355,No,45.15%,5906,42%,233,1.66%
22015,Louisiana,Bossier Parish,122197,60336,61861,45443,45131,41877,42269,84146,38051,No,31.14%,25892,21%,7565,6.19%
22017,Louisiana,Caddo Parish,257093,122204,134889,61786,64574,58933,62220,121153,135940,Yes,52.88%,122713,48%,6667,2.59%
22019,Louisiana,Calcasieu Parish,194493,94861,99632,67968,71001,65708,68895,134603,59890,No,30.79%,48854,25%,5413,2.78%
22021,Louisiana,Caldwell Parish,10004,5140,4864,4087,4023,3976,3930,7906,2098,No,20.97%,1739,17%,239,2.39%
22023,Louisiana,Cameron Parish,6702,3317,3385,3198,3269,3107,3170,6277,425,No,6.34%,125,2%,204,3.04%
22025,Louisiana,Catahoula Parish,10292,5459,4833,3524,3351,3484,3309,6793,3499,No,34.00%,3294,32%,99,0.96%
22027,Louisiana,Claiborne Parish,16828,9472,7356,4276,3713,4201,3630,7831,8997,Yes,53.46%,8508,51%,231,1.37%
22029,Louisiana,Concordia Parish,20365,10268,10097,5924,5861,5810,5777,11587,8778,No,43.10%,8287,41%,247,1.21%
22031,Louisiana,De Soto Parish,26963,12955,14008,7843,8107,7575,7840,15415,11548,No,42.83%,10372,38%,711,2.64%
22033,Louisiana,East Baton Rouge Parish,444526,213482,231044,108527,111373,100547,105156,205703,238823,Yes,53.73%,204175,46%,17023,3.83%
22035,Louisiana,East Carroll Parish,7526,4061,3465,1227,1035,1174,1001,2175,5351,Yes,71.10%,5122,68%,148,1.97%
22037,Louisiana,East Feliciana Parish,20008,10741,9267,5642,5057,5555,4984,10539,9469,No,47.33%,8920,45%,240,1.20%
22039,Louisiana,Evangeline Parish,33710,17009,16701,11839,11699,11376,11537,22913,10797,No,32.03%,9583,28%,782,2.32%
22041,Louisiana,Franklin Parish,20561,9993,10568,6765,7027,6676,6971,13647,6914,No,33.63%,6496,32%,235,1.14%
22043,Louisiana,Grant Parish,22068,12322,9746,9517,8402,8771,8282,17053,5015,No,22.73%,3458,16%,971,4.40%
22045,Louisiana,Iberia Parish,73999,36159,37840,23164,23505,22009,22624,44633,29366,No,39.68%,23904,32%,2480,3.35%
22047,Louisiana,Iberville Parish,33228,16951,16277,8356,8128,8024,7908,15932,17296,Yes,52.05%,16257,49%,776,2.34%
22049,Louisiana,Jackson Parish,16216,8267,7949,5635,5511,5534,5411,10945,5271,No,32.50%,4776,29%,242,1.49%
22051,Louisiana,Jefferson Parish,433676,210774,222902,142458,146876,115445,123579,239024,194652,No,44.88%,116892,27%,56853,13.11%
22053,Louisiana,Jefferson Davis Parish,31432,15375,16057,12313,12894,12029,12690,24719,6713,No,21.36%,5392,17%,579,1.84%
22055,Louisiana,Lafayette Parish,227055,110758,116297,79054,81137,74540,77634,152174,74881,No,32.98%,59153,26%,9302,4.10%
22057,Louisiana,Lafourche Parish,97029,47782,49247,38877,39791,36865,38406,75271,21758,No,22.42%,13004,13%,3961,4.08%
22059,Louisiana,La Salle Parish,14927,7732,7195,6423,6318,6200,6236,12436,2491,No,16.69%,1859,12%,361,2.42%
22061,Louisiana,Lincoln Parish,46953,22832,24121,13057,12881,12495,12462,24957,21996,No,46.85%,19439,41%,1261,2.69%
22063,Louisiana,Livingston Parish,131942,65403,66539,60317,61312,58231,59642,117873,14069,No,10.66%,7561,6%,4163,3.16%
22065,Louisiana,Madison Parish,12154,6053,6101,2174,2258,2105,2184,4289,7865,Yes,64.71%,7560,62%,189,1.56%
22067,Louisiana,Morehouse Parish,27559,13225,14334,6815,7189,6703,7106,13809,13750,No,49.89%,13105,48%,309,1.12%
22069,Louisiana,Natchitoches Parish,39436,18768,20668,10528,11153,10278,10883,21161,18275,No,46.34%,16361,41%,752,1.91%
22071,Louisiana,Orleans Parish,369250,177379,191871,65764,62707,57507,56380,113887,255363,Yes,69.16%,222892,60%,19656,5.32%
22073,Louisiana,Ouachita Parish,155363,74477,80886,45681,48427,44425,47334,91759,63604,No,40.94%,57407,37%,3124,2.01%
22075,Louisiana,Plaquemines Parish,23921,12020,11901,8638,8508,8110,7991,16101,7820,No,32.69%,4944,21%,1312,5.48%
22077,Louisiana,Pointe Coupee Parish,22726,10973,11753,7008,7154,6777,6973,13750,8976,No,39.50%,8206,36%,516,2.27%
22079,Louisiana,Rapides Parish,132373,63882,68491,41311,43582,39620,42272,81892,50481,No,38.14%,42463,32%,3625,2.74%
22081,Louisiana,Red River Parish,8983,4326,4657,2624,2698,2564,2658,5222,3761,No,41.87%,3551,40%,121,1.35%
22083,Louisiana,Richland Parish,20921,10068,10853,6374,6762,6209,6606,12815,8106,No,38.75%,7458,36%,398,1.90%
22085,Louisiana,Sabine Parish,24325,12113,12212,8617,8602,8346,8370,16716,7609,No,31.28%,4072,17%,871,3.58%
22087,Louisiana,St. Bernard Parish,41635,20848,20787,15781,15166,13841,13633,27474,14161,No,34.01%,8491,20%,4033,9.69%
22089,Louisiana,St. Charles Parish,52681,26064,26617,18581,18647,17306,17448,34754,17927,No,34.03%,14000,27%,2880,5.47%
22091,Louisiana,St. Helena Parish,11071,5437,5634,2484,2517,2442,2478,4920,6151,Yes,55.56%,5901,53%,138,1.25%
22093,Louisiana,St. James Parish,21722,10570,11152,5312,5300,5184,5183,10367,11355,Yes,52.27%,10864,50%,311,1.43%
22095,Louisiana,St. John the Baptist Parish,44758,21941,22817,9741,9627,8767,8781,17548,27210,Yes,60.79%,24319,54%,2278,5.09%
22097,Louisiana,St. Landry Parish,83662,40080,43582,23009,24345,22443,23843,46286,37376,No,44.68%,34730,42%,1451,1.73%
22099,Louisiana,St. Martin Parish,52726,25962,26764,17584,17653,17038,17211,34249,18477,No,35.04%,16183,31%,1233,2.34%
22101,Louisiana,St. Mary Parish,53697,26500,27197,16613,16541,15051,15566,30617,23080,No,42.98%,17597,33%,3068,5.71%
22103,Louisiana,St. Tammany Parish,239453,116377,123076,98813,103639,93242,98508,191750,47703,No,19.92%,28297,12%,11980,5.00%
22105,Louisiana,Tangipahoa Parish,123441,59872,63569,40860,42301,38658,40605,79263,44178,No,35.79%,37371,30%,4523,3.66%
22107,Louisiana,Tensas Parish,4954,2407,2547,1054,1085,1021,1061,2082,2872,Yes,57.97%,2755,56%,70,1.41%
22109,Louisiana,Terrebonne Parish,111893,55320,56573,40183,40467,37796,38743,76539,35354,No,31.60%,21242,19%,4821,4.31%
22111,Louisiana,Union Parish,22419,11014,11405,7974,8100,7547,7702,15249,7170,No,31.98%,6046,27%,972,4.34%
22113,Louisiana,Vermilion Parish,58723,28540,30183,23272,24631,22604,23942,46546,12177,No,20.74%,8546,15%,1604,2.73%
22115,Louisiana,Vernon Parish,53869,28042,25827,21936,20043,19811,18414,38225,15644,No,29.04%,7924,15%,4645,8.62%
22117,Louisiana,Washington Parish,46670,23139,23531,15588,15928,15151,15591,30742,15928,No,34.13%,14348,31%,933,2.00%
22119,Louisiana,Webster Parish,40940,20005,20935,13033,13290,12726,13040,25766,15174,No,37.06%,13720,34%,733,1.79%
22121,Louisiana,West Baton Rouge Parish,24106,11860,12246,7285,7328,6927,7110,14037,10069,No,41.77%,9061,38%,675,2.80%
22123,Louisiana,West Carroll Parish,11512,5762,5750,4635,4787,4499,4681,9180,2332,No,20.26%,1866,16%,314,2.73%
22125,Louisiana,West Feliciana Parish,15405,10110,5295,4651,3490,4549,3407,7956,7449,No,48.35%,7098,46%,230,1.49%
22127,Louisiana,Winn Parish,15000,7913,7087,5105,4926,4985,4845,9830,5170,No,34.47%,4635,31%,258,1.72%
23001,Maine,Androscoggin County,107609,52743,54866,49001,51173,48313,50437,98750,8859,No,8.23%,4031,4%,1776,1.65%
23003,Maine,Aroostook County,70868,34962,35906,33453,34303,33122,34058,67180,3688,No,5.20%,554,1%,722,1.02%
23005,Maine,Cumberland County,283921,137858,146063,127941,135969,125694,133776,259470,24451,No,8.61%,7614,3%,5511,1.94%
23007,Maine,Franklin County,30630,15015,15615,14634,15186,14492,15037,29529,1101,No,3.59%,96,0%,325,1.06%
23009,Maine,Hancock County,54558,26631,27927,25827,26996,25534,26675,52209,2349,No,4.31%,280,1%,724,1.33%
23011,Maine,Kennebec County,121853,59294,62559,57112,60307,56449,59629,116078,5775,No,4.74%,828,1%,1582,1.30%
23013,Maine,Knox County,39668,19584,20084,18994,19515,18804,19345,38149,1519,No,3.83%,223,1%,395,1.00%
23015,Maine,Lincoln County,34180,16756,17424,16330,16969,16218,16825,33043,1137,No,3.33%,149,0%,314,0.92%
23017,Maine,Oxford County,57481,28509,28972,27600,28174,27323,27911,55234,2247,No,3.91%,231,0%,615,1.07%
23019,Maine,Penobscot County,153746,75738,78008,72089,74650,71346,73871,145217,8529,No,5.55%,1316,1%,1788,1.16%
23021,Maine,Piscataquis County,17290,8606,8684,8334,8435,8255,8357,16612,678,No,3.92%,80,0%,185,1.07%
23023,Maine,Sagadahoc County,35191,17067,18124,16428,17432,16215,17209,33424,1767,No,5.02%,288,1%,504,1.43%
23025,Maine,Somerset County,51910,25716,26194,24966,25413,24778,25200,49978,1932,No,3.72%,218,0%,472,0.91%
23027,Maine,Waldo County,38820,18979,19841,18450,19285,18274,19139,37413,1407,No,3.62%,178,0%,395,1.02%
23029,Maine,Washington County,32462,15984,16478,14746,15226,14496,15019,29515,2947,No,9.08%,187,1%,542,1.67%
23031,Maine,York County,199005,96836,102169,93358,98553,92214,97350,189564,9441,No,4.74%,1330,1%,2749,1.38%
24001,Maryland,Allegany County,74012,38481,35531,32738,33203,32076,32896,64972,9040,No,12.21%,6101,8%,1170,1.58%
24003,Maryland,Anne Arundel County,550488,272378,278110,210895,212485,195234,198441,393675,156813,No,28.49%,88811,16%,36204,6.58%
24005,Maryland,Baltimore County,817455,386748,430707,254625,275356,239746,261931,501677,315778,No,38.63%,220756,27%,37388,4.57%
24009,Maryland,Calvert County,89628,44140,45488,36476,36989,35384,35857,71241,18387,No,20.51%,11999,13%,2766,3.09%
24011,Maryland,Caroline County,32718,15875,16843,13100,13708,12342,13100,25442,7276,No,22.24%,4676,14%,1859,5.68%
24013,Maryland,Carroll County,167217,82529,84688,76768,79190,74562,77229,151791,15426,No,9.23%,5634,3%,4671,2.79%
24015,Maryland,Cecil County,101696,50452,51244,45345,46134,43681,44738,88419,13277,No,13.06%,6567,6%,3772,3.71%
24017,Maryland,Charles County,150592,72632,77960,37445,37914,35057,35510,70567,80025,Yes,53.14%,63793,42%,7043,4.68%
24019,Maryland,Dorchester County,32551,15621,16930,10877,11469,10345,11005,21350,11201,No,34.41%,9129,28%,1315,4.04%
24021,Maryland,Frederick County,239582,118086,121496,98901,101537,90592,93810,184402,55180,No,23.03%,21760,9%,18744,7.82%
24023,Maryland,Garrett County,29854,14800,15054,14447,14722,14328,14614,28942,912,No,3.05%,319,1%,242,0.81%
24025,Maryland,Harford County,248622,121751,126871,99493,102892,95544,99412,194956,53666,No,21.59%,32516,13%,9530,3.83%
24027,Maryland,Howard County,299430,147031,152399,92842,93816,85502,86897,172399,127031,No,42.42%,54265,18%,18471,6.17%
24029,Maryland,Kent County,20191,9657,10534,7928,8588,7469,8315,15784,4407,No,21.83%,3074,15%,910,4.51%
24031,Maryland,Montgomery County,1004709,483887,520822,310417,324121,232458,248274,480732,523977,Yes,52.15%,183896,18%,180214,17.94%
24033,Maryland,Prince George's County,881138,423362,457776,122928,110795,65489,64490,129979,751159,Yes,85.25%,575447,65%,138547,15.72%
24035,Maryland,Queen Anne's County,48595,24146,24449,21687,21967,20931,21372,42303,6292,No,12.95%,3401,7%,1580,3.25%
24037,Maryland,St. Mary's County,108987,54346,54641,43599,43009,41695,41156,82851,26136,No,23.98%,15612,14%,4641,4.26%
24039,Maryland,Somerset County,26253,14173,12080,7426,6900,7090,6537,13627,12626,No,48.09%,11125,42%,946,3.60%
24041,Maryland,Talbot County,38098,18122,19976,15204,16616,14242,15766,30008,8090,No,21.23%,5048,13%,2182,5.73%
24043,Maryland,Washington County,149180,76195,72985,62796,64301,60362,62206,122568,26612,No,17.84%,15545,10%,5618,3.77%
24045,Maryland,Wicomico County,100647,48168,52479,33628,36351,31557,34612,66169,34478,No,34.26%,25016,25%,4932,4.90%
24047,Maryland,Worcester County,51578,25029,26549,20896,21914,20125,21231,41356,10222,No,19.82%,7117,14%,1694,3.28%
24510,Maryland,Baltimore city,621342,292794,328548,96981,97857,85844,89234,175078,446264,Yes,71.82%,395383,64%,27571,4.44%
25001,Massachusetts,Barnstable County,215423,102624,112799,96108,106420,93939,104349,198288,17135,No,7.95%,5016,2%,5169,2.40%
25003,Massachusetts,Berkshire County,130016,62760,67256,58327,62832,56340,60937,117277,12739,No,9.80%,3942,3%,4839,3.72%
25005,Massachusetts,Bristol County,551082,267121,283961,242714,259312,229147,245784,474931,76151,No,13.82%,23757,4%,35363,6.42%
25007,Massachusetts,Dukes County,17041,8448,8593,7695,7845,7521,7695,15216,1825,No,10.71%,614,4%,448,2.63%
25009,Massachusetts,Essex County,755618,363773,391845,318182,344211,271511,295776,567287,188331,No,24.92%,43340,6%,131598,17.42%
25011,Massachusetts,Franklin County,71540,34976,36564,33081,34755,32008,33783,65791,5749,No,8.04%,960,1%,2514,3.51%
25013,Massachusetts,Hampden County,465923,224531,241392,188769,202568,149857,160312,310169,155754,No,33.43%,49130,11%,102369,21.97%
25015,Massachusetts,Hampshire County,159795,74585,85210,67122,76173,64218,72817,137035,22760,No,14.24%,4654,3%,7932,4.96%
25017,Massachusetts,Middlesex County,1537215,749187,788028,615856,648929,570358,604102,1174460,362755,No,23.60%,80955,5%,107168,6.97%
25019,Massachusetts,Nantucket County,10298,5260,5038,4700,4521,4082,4120,8202,2096,No,20.35%,759,7%,1075,10.44%
25021,Massachusetts,Norfolk County,681845,326601,355244,269560,291869,260054,282019,542073,139772,No,20.50%,43817,6%,24630,3.61%
25023,Massachusetts,Plymouth County,499759,243197,256562,212125,223692,205661,217535,423196,76563,No,15.32%,46523,9%,16928,3.39%
25025,Massachusetts,Suffolk County,744426,359598,384828,232027,237928,175156,181715,356871,387555,Yes,52.06%,182419,25%,154839,20.80%
25027,Massachusetts,Worcester County,806163,397712,408451,350620,362281,317735,329392,647127,159036,No,19.73%,39913,5%,79201,9.82%
26001,Michigan,Alcona County,10635,5372,5263,5285,5141,5221,5071,10292,343,No,3.23%,20,0%,138,1.30%
26003,Michigan,Alger County,9541,5213,4328,4232,3954,4185,3914,8099,1442,No,15.11%,648,7%,116,1.22%
26005,Michigan,Allegan County,112039,55740,56299,53269,53739,49676,50402,100078,11961,No,10.68%,1538,1%,7709,6.88%
26007,Michigan,Alpena County,29234,14383,14851,14005,14464,13830,14306,28136,1098,No,3.76%,110,0%,361,1.23%
26009,Michigan,Antrim County,23406,11622,11784,11268,11422,11076,11228,22304,1102,No,4.71%,73,0%,434,1.85%
26011,Michigan,Arenac County,15477,7888,7589,7656,7331,7524,7233,14757,720,No,4.65%,52,0%,260,1.68%
26013,Michigan,Baraga County,8683,4753,3930,3338,3102,3306,3079,6385,2298,No,26.47%,650,7%,108,1.24%
26015,Michigan,Barry County,58990,29701,29289,28894,28518,28220,27908,56128,2862,No,4.85%,282,0%,1442,2.44%
26017,Michigan,Bay County,106935,52454,54481,49889,51925,47586,49634,97220,9715,No,9.08%,1770,2%,5216,4.88%
26019,Michigan,Benzie County,17465,8688,8777,8375,8449,8231,8285,16516,949,No,5.43%,101,1%,342,1.96%
26021,Michigan,Berrien County,156067,76117,79950,61085,63346,57774,60256,118030,38037,No,24.37%,24358,16%,7535,4.83%
26023,Michigan,Branch County,43868,22599,21269,21226,20619,20336,19842,40178,3690,No,8.41%,893,2%,1839,4.19%
26025,Michigan,Calhoun County,135099,65977,69122,54861,57776,52233,55247,107480,27619,No,20.44%,14930,11%,6259,4.63%
26027,Michigan,Cass County,52242,26046,26196,23331,23585,22578,22934,45512,6730,No,12.88%,2835,5%,1636,3.13%
26029,Michigan,Charlevoix County,26023,12832,13191,12301,12613,12136,12465,24601,1422,No,5.46%,98,0%,387,1.49%
26031,Michigan,Cheboygan County,25835,12872,12963,12006,12102,11894,12002,23896,1939,No,7.51%,156,1%,288,1.11%
26033,Michigan,Chippewa County,38917,21509,17408,14960,13203,14722,12989,27711,11206,No,28.79%,2683,7%,670,1.72%
26035,Michigan,Clare County,30753,15346,15407,14861,14954,14645,14707,29352,1401,No,4.56%,175,1%,511,1.66%
26037,Michigan,Clinton County,76001,37505,38496,35345,36335,33855,34945,68800,7201,No,9.47%,1492,2%,3206,4.22%
26039,Michigan,Crawford County,14009,7044,6965,6845,6757,6750,6660,13410,599,No,4.28%,85,1%,239,1.71%
26041,Michigan,Delta County,36884,18297,18587,17299,17618,17164,17475,34639,2245,No,6.09%,104,0%,351,0.95%
26043,Michigan,Dickinson County,26220,13020,13200,12655,12820,12525,12684,25209,1011,No,3.86%,107,0%,315,1.20%
26045,Michigan,Eaton County,108008,52671,55337,46662,49013,44385,46658,91043,16965,No,15.71%,7362,7%,5408,5.01%
26047,Michigan,Emmet County,32915,16242,16673,15042,15517,14896,15343,30239,2676,No,8.13%,204,1%,450,1.37%
26049,Michigan,Genesee County,418408,201640,216768,152938,161292,147607,155928,303535,114873,No,27.45%,87282,21%,13169,3.15%
26051,Michigan,Gladwin County,25484,12797,12687,12507,12416,12355,12265,24620,864,No,3.39%,93,0%,326,1.28%
26053,Michigan,Gogebic County,16084,8643,7441,7624,7045,7535,6979,14514,1570,No,9.76%,695,4%,179,1.11%
26055,Michigan,Grand Traverse County,89112,43904,45208,41359,43306,40384,42401,82785,6327,No,7.10%,1171,1%,2190,2.46%
26057,Michigan,Gratiot County,42063,22430,19633,19687,19045,18531,18099,36630,5433,No,12.92%,2420,6%,2269,5.39%
26059,Michigan,Hillsdale County,46229,22949,23280,22352,22655,21928,22261,44189,2040,No,4.41%,267,1%,894,1.93%
26061,Michigan,Houghton County,36520,19746,16774,18543,15922,18296,15765,34061,2459,No,6.73%,299,1%,489,1.34%
26063,Michigan,Huron County,32463,16088,16375,15730,16028,15412,15732,31144,1319,No,4.06%,155,0%,645,1.99%
26065,Michigan,Ingham County,281723,136404,145319,106654,113441,98169,105003,203172,78551,No,27.88%,34017,12%,21036,7.47%
26067,Michigan,Ionia County,63941,34314,29627,30530,28722,28935,27664,56599,7342,No,11.48%,3141,5%,3011,4.71%
26069,Michigan,Iosco County,25357,12527,12830,12081,12322,11876,12155,24031,1326,No,5.23%,145,1%,446,1.76%
26071,Michigan,Iron County,11587,5721,5866,5558,5681,5494,5598,11092,495,No,4.27%,27,0%,184,1.59%
26073,Michigan,Isabella County,70617,34318,36299,30573,32534,29655,31692,61347,9270,No,13.13%,1842,3%,2483,3.52%
26075,Michigan,Jackson County,160309,82035,78274,70917,70272,68669,68290,136959,23350,No,14.57%,13232,8%,5049,3.15%
26077,Michigan,Kalamazoo County,254580,124778,129802,103080,107232,98763,103020,201783,52797,No,20.74%,28399,11%,10880,4.27%
26079,Michigan,Kalkaska County,17099,8678,8421,8383,8152,8285,8040,16325,774,No,4.53%,68,0%,246,1.44%
26081,Michigan,Kent County,614462,301583,312879,252684,261455,226988,237226,464214,150248,No,24.45%,63332,10%,60834,9.90%
26083,Michigan,Keweenaw County,2215,1130,1085,1111,1070,1108,1062,2170,45,No,2.03%,4,0%,18,0.81%
26085,Michigan,Lake County,11498,5861,5637,5130,4904,5045,4792,9837,1661,No,14.45%,1055,9%,274,2.38%
26087,Michigan,Lapeer County,88173,44534,43639,42759,42433,41015,40664,81679,6494,No,7.37%,1063,1%,3772,4.28%
26089,Michigan,Leelanau County,21607,10666,10941,10028,10216,9723,9944,19667,1940,No,8.98%,88,0%,803,3.72%
26091,Michigan,Lenawee County,98987,50137,48850,46606,46670,43124,43348,86472,12515,No,12.64%,2768,3%,7556,7.63%
26093,Michigan,Livingston County,182838,91372,91466,88526,88593,86819,86911,173730,9108,No,4.98%,1080,1%,3754,2.05%
26095,Michigan,Luce County,6522,3750,2772,2760,2493,2722,2466,5188,1334,No,20.45%,715,11%,87,1.33%
26097,Michigan,Mackinac County,11137,5670,5467,4291,4157,4240,4095,8335,2802,No,25.16%,119,1%,164,1.47%
26099,Michigan,Macomb County,847383,411888,435495,350132,365560,341413,357146,698559,148824,No,17.56%,83600,10%,20223,2.39%
26101,Michigan,Manistee County,24672,12802,11870,11473,11272,11167,10991,22158,2514,No,10.19%,800,3%,681,2.76%
26103,Michigan,Marquette County,67906,34241,33665,31785,31978,31399,31633,63032,4874,No,7.18%,1160,2%,887,1.31%
26105,Michigan,Mason County,28680,14183,14497,13602,13916,13044,13434,26478,2202,No,7.68%,217,1%,1177,4.10%
26107,Michigan,Mecosta County,43318,21780,21538,20336,20169,19987,19829,39816,3502,No,8.08%,1246,3%,839,1.94%
26109,Michigan,Menominee County,23815,11990,11825,11429,11235,11315,11085,22400,1415,No,5.94%,100,0%,327,1.37%
26111,Michigan,Midland County,83822,41196,42626,38961,40378,38095,39560,77655,6167,No,7.36%,1075,1%,1855,2.21%
26113,Michigan,Missaukee County,15031,7614,7417,7410,7191,7239,7058,14297,734,No,4.88%,62,0%,370,2.46%
26115,Michigan,Monroe County,151048,74469,76579,70815,72841,68612,70711,139323,11725,No,7.76%,3458,2%,4890,3.24%
26117,Michigan,Montcalm County,63097,32696,30401,30503,29496,29531,28711,58242,4855,No,7.69%,1572,2%,1968,3.12%
26119,Michigan,Montmorency County,9476,4792,4684,4680,4574,4622,4530,9152,324,No,3.42%,32,0%,110,1.16%
26121,Michigan,Muskegon County,170182,83957,86225,68504,70139,64860,66634,131494,38688,No,22.73%,24307,14%,8599,5.05%
26123,Michigan,Newaygo County,47959,24090,23869,23148,22964,21854,21778,43632,4327,No,9.02%,535,1%,2715,5.66%
26125,Michigan,Oakland County,1220657,591976,628681,463326,479851,443936,461142,905078,315579,No,25.85%,174346,14%,44808,3.67%
26127,Michigan,Oceana County,26310,13170,13140,12655,12626,10862,10976,21838,4472,No,17.00%,158,1%,3727,14.17%
26129,Michigan,Ogemaw County,21437,10634,10803,10315,10488,10163,10343,20506,931,No,4.34%,64,0%,360,1.68%
26131,Michigan,Ontonagon County,6413,3293,3120,3210,3009,3183,2983,6166,247,No,3.85%,12,0%,65,1.01%
26133,Michigan,Osceola County,23276,11706,11570,11301,11203,11138,11034,22172,1104,No,4.74%,169,1%,388,1.67%
26135,Michigan,Oscoda County,8592,4373,4219,4266,4103,4227,4057,8284,308,No,3.58%,22,0%,100,1.16%
26137,Michigan,Otsego County,24020,11864,12156,11454,11786,11317,11610,22927,1093,No,4.55%,102,0%,351,1.46%
26139,Michigan,Ottawa County,269099,132224,136875,123342,127688,112119,117060,229179,39920,No,14.83%,4518,2%,24299,9.03%
26141,Michigan,Presque Isle County,13129,6593,6536,6421,6366,6367,6321,12688,441,No,3.36%,65,0%,125,0.95%
26143,Michigan,Roscommon County,24106,12007,12099,11665,11756,11544,11616,23160,946,No,3.92%,131,1%,302,1.25%
26145,Michigan,Saginaw County,198353,96122,102231,74312,78049,67914,71471,139385,58968,No,29.73%,38562,19%,15743,7.94%
26147,Michigan,St. Clair County,160644,79654,80990,75230,76639,73186,74493,147679,12965,No,8.07%,4040,3%,4844,3.02%
26149,Michigan,St. Joseph County,60796,30184,30612,28336,28803,26328,27002,53330,7466,No,12.28%,1669,3%,4146,6.82%
26151,Michigan,Sanilac County,42268,21046,21222,20488,20736,19761,20094,39855,2413,No,5.71%,208,0%,1542,3.65%
26153,Michigan,Schoolcraft County,8343,4133,4210,3598,3660,3573,3639,7212,1131,No,13.56%,16,0%,69,0.83%
26155,Michigan,Shiawassee County,69232,34204,35028,33169,34038,32395,33256,65651,3581,No,5.17%,408,1%,1788,2.58%
26157,Michigan,Tuscola County,54662,27405,27257,26449,26446,25689,25718,51407,3255,No,5.95%,673,1%,1660,3.04%
26159,Michigan,Van Buren County,75454,37327,38127,34249,34847,30494,31418,61912,13542,No,17.95%,3231,4%,8005,10.61%
26161,Michigan,Washtenaw County,350946,173206,177740,130672,133247,124471,127181,251652,99294,No,28.29%,45271,13%,14978,4.27%
26163,Michigan,Wayne County,1792365,861857,930508,480609,494381,438440,454014,892454,899911,Yes,50.21%,718931,40%,97870,5.46%
26165,Michigan,Wexford County,32608,16269,16339,15728,15795,15500,15562,31062,1546,No,4.74%,144,0%,541,1.66%
27001,Minnesota,Aitkin County,15927,8082,7845,7721,7474,7663,7415,15078,849,No,5.33%,65,0%,166,1.04%
27003,Minnesota,Anoka County,336414,168276,168138,147521,147615,141828,142445,284273,52141,No,15.50%,16308,5%,12740,3.79%
27005,Minnesota,Becker County,33000,16493,16507,14582,14514,14414,14373,28787,4213,No,12.77%,148,0%,501,1.52%
27007,Minnesota,Beltrami County,45375,22694,22681,17023,16955,16816,16765,33581,11794,No,25.99%,309,1%,758,1.67%
27009,Minnesota,Benton County,38865,19457,19408,18398,18402,18099,18100,36199,2666,No,6.86%,875,2%,687,1.77%
27011,Minnesota,Big Stone County,5164,2529,2635,2479,2588,2461,2564,5025,139,No,2.69%,15,0%,50,0.97%
27013,Minnesota,Blue Earth County,65091,32707,32384,30162,30221,29347,29449,58796,6295,No,9.67%,2012,3%,1806,2.77%
27015,Minnesota,Brown County,25425,12652,12773,12422,12544,11973,12156,24129,1296,No,5.10%,87,0%,882,3.47%
27017,Minnesota,Carlton County,35348,18363,16985,16274,15462,16035,15354,31389,3959,No,11.20%,527,1%,519,1.47%
27019,Minnesota,Carver County,93707,46520,47187,43780,44285,42032,42614,84646,9061,No,9.67%,1284,1%,3775,4.03%
27021,Minnesota,Cass County,28357,14459,13898,12425,11805,12311,11691,24002,4355,No,15.36%,85,0%,399,1.41%
27023,Minnesota,Chippewa County,12135,5956,6179,5692,5922,5390,5616,11006,1129,No,9.30%,73,1%,637,5.25%
27025,Minnesota,Chisago County,53452,27582,25870,26242,25054,25769,24727,50496,2956,No,5.53%,679,1%,903,1.69%
27027,Minnesota,Clay County,60155,29650,30505,27651,28677,26591,27723,54314,5841,No,9.71%,895,1%,2292,3.81%
27029,Minnesota,Clearwater County,8703,4394,4309,3832,3750,3795,3717,7512,1191,No,13.68%,25,0%,122,1.40%
27031,Minnesota,Cook County,5185,2557,2628,2232,2301,2209,2275,4484,701,No,13.52%,31,1%,77,1.49%
27033,Minnesota,Cottonwood County,11597,5709,5888,5373,5563,5037,5223,10260,1337,No,11.53%,103,1%,765,6.60%
27035,Minnesota,Crow Wing County,62882,31321,31561,30264,30555,29984,30262,60246,2636,No,4.19%,360,1%,725,1.15%
27037,Minnesota,Dakota County,405088,199139,205949,173224,179269,161695,168641,330336,74752,No,18.45%,20903,5%,25438,6.28%
27039,Minnesota,Dodge County,20231,10082,10149,9863,9866,9423,9474,18897,1334,No,6.59%,101,0%,923,4.56%
27041,Minnesota,Douglas County,36415,18180,18235,17739,17841,17541,17669,35210,1205,No,3.31%,191,1%,450,1.24%
27043,Minnesota,Faribault County,14263,7085,7178,6934,7025,6527,6648,13175,1088,No,7.63%,64,0%,845,5.92%
27045,Minnesota,Fillmore County,20834,10427,10407,10261,10243,10160,10167,20327,507,No,2.43%,65,0%,214,1.03%
27047,Minnesota,Freeborn County,31054,15421,15633,14800,15143,13428,13864,27292,3762,No,12.11%,321,1%,2834,9.13%
27049,Minnesota,Goodhue County,46336,22976,23360,21879,22354,21192,21803,42995,3341,No,7.21%,523,1%,1431,3.09%
27051,Minnesota,Grant County,5944,2954,2990,2903,2918,2859,2881,5740,204,No,3.43%,24,0%,103,1.73%
27053,Minnesota,Hennepin County,1184576,583172,601404,447345,461343,411666,430520,842186,342390,No,28.90%,145709,12%,81432,6.87%
27055,Minnesota,Houston County,18837,9349,9488,9124,9230,9058,9180,18238,599,No,3.18%,116,1%,161,0.85%
27057,Minnesota,Hubbard County,20347,10252,10095,9734,9547,9588,9439,19027,1320,No,6.49%,74,0%,346,1.70%
27059,Minnesota,Isanti County,38248,19252,18996,18520,18303,18267,18029,36296,1952,No,5.10%,271,1%,640,1.67%
27061,Minnesota,Itasca County,45221,22828,22393,21256,20959,21084,20788,41872,3349,No,7.41%,163,0%,481,1.06%
27063,Minnesota,Jackson County,10281,5241,5040,5040,4867,4887,4744,9631,650,No,6.32%,47,0%,321,3.12%
27065,Minnesota,Kanabec County,16005,8105,7900,7878,7659,7769,7545,15314,691,No,4.32%,73,0%,249,1.56%
27067,Minnesota,Kandiyohi County,42379,21212,21167,20035,20185,17702,18051,35753,6626,No,15.64%,1290,3%,4733,11.17%
27069,Minnesota,Kittson County,4493,2262,2231,2230,2195,2186,2166,4352,141,No,3.14%,14,0%,79,1.76%
27071,Minnesota,Koochiching County,13208,6632,6576,6293,6209,6225,6154,12379,829,No,6.28%,97,1%,156,1.18%
27073,Minnesota,Lac qui Parle County,7109,3578,3531,3498,3462,3425,3411,6836,273,No,3.84%,20,0%,145,2.04%
27075,Minnesota,Lake County,10818,5475,5343,5348,5193,5301,5147,10448,370,No,3.42%,39,0%,104,0.96%
27077,Minnesota,Lake of the Woods County,3973,2032,1941,1962,1858,1944,1835,3779,194,No,4.88%,13,0%,49,1.23%
27079,Minnesota,Le Sueur County,27677,13952,13725,13598,13399,12829,12705,25534,2143,No,7.74%,135,0%,1510,5.46%
27081,Minnesota,Lincoln County,5818,2911,2907,2874,2869,2822,2839,5661,157,No,2.70%,7,0%,90,1.55%
27083,Minnesota,Lyon County,25543,12739,12804,11732,11981,11005,11307,22312,3231,No,12.65%,613,2%,1566,6.13%
27085,Minnesota,McLeod County,36053,17905,18148,17420,17670,16526,16832,33358,2695,No,7.48%,227,1%,1864,5.17%
27087,Minnesota,Mahnomen County,5536,2783,2753,1384,1365,1370,1351,2721,2815,Yes,50.85%,16,0%,131,2.37%
27089,Minnesota,Marshall County,9449,4795,4654,4700,4539,4542,4374,8916,533,No,5.64%,39,0%,359,3.80%
27091,Minnesota,Martin County,20475,10079,10396,9847,10162,9475,9830,19305,1170,No,5.71%,88,0%,781,3.81%
27093,Minnesota,Meeker County,23061,11791,11270,11567,11092,11212,10766,21978,1083,No,4.70%,101,0%,751,3.26%
27095,Minnesota,Mille Lacs County,25740,12958,12782,11904,11616,11741,11500,23241,2499,No,9.71%,109,0%,412,1.60%
27097,Minnesota,Morrison County,33052,16656,16396,16260,16032,16053,15831,31884,1168,No,3.53%,151,0%,463,1.40%
27099,Minnesota,Mower County,39372,19611,19761,18185,18508,15994,16573,32567,6805,No,17.28%,1183,3%,4375,11.11%
27101,Minnesota,Murray County,8577,4268,4309,4153,4203,4049,4090,8139,438,No,5.11%,34,0%,258,3.01%
27103,Minnesota,Nicollet County,32929,16414,16515,15465,15692,14852,15144,29996,2933,No,8.91%,740,2%,1268,3.85%
27105,Minnesota,Nobles County,21487,11076,10411,9598,9166,6978,7041,14019,7468,No,34.76%,838,4%,5130,23.87%
27107,Minnesota,Norman County,6634,3330,3304,3183,3136,3059,3011,6070,564,No,8.50%,24,0%,271,4.09%
27109,Minnesota,Olmsted County,147066,71964,75102,61883,65276,58756,62636,121392,25674,No,17.46%,7853,5%,6494,4.42%
27111,Minnesota,Otter Tail County,57288,28805,28483,27830,27521,27056,26841,53897,3391,No,5.92%,590,1%,1637,2.86%
27113,Minnesota,Pennington County,14074,6964,7110,6547,6737,6362,6558,12920,1154,No,8.20%,186,1%,451,3.20%
27115,Minnesota,Pine County,29218,15595,13623,14098,12850,13682,12675,26357,2861,No,9.79%,628,2%,725,2.48%
27117,Minnesota,Pipestone County,9345,4560,4785,4333,4537,4160,4391,8551,794,No,8.50%,114,1%,406,4.34%
27119,Minnesota,Polk County,31416,15764,15652,14882,14834,14058,14060,28118,3298,No,10.50%,345,1%,1813,5.77%
27121,Minnesota,Pope County,10892,5506,5386,5401,5266,5359,5230,10589,303,No,2.78%,43,0%,101,0.93%
27123,Minnesota,Ramsey County,520152,252643,267509,180397,192339,164408,177934,342342,177810,No,34.18%,59240,11%,37888,7.28%
27125,Minnesota,Red Lake County,4087,2049,2038,1973,1931,1927,1892,3819,268,No,6.56%,34,1%,109,2.67%
27127,Minnesota,Redwood County,15847,7871,7976,7056,7155,6923,7042,13965,1882,No,11.88%,104,1%,363,2.29%
27129,Minnesota,Renville County,15369,7815,7554,7573,7324,7029,6825,13854,1515,No,9.86%,55,0%,1110,7.22%
27131,Minnesota,Rice County,64854,33182,31672,30157,29548,27577,27442,55019,9835,No,15.16%,2361,4%,5094,7.85%
27133,Minnesota,Rock County,9553,4700,4853,4541,4721,4461,4618,9079,474,No,4.96%,70,1%,206,2.16%
27135,Minnesota,Roseau County,15476,7901,7575,7466,7149,7410,7103,14513,963,No,6.22%,49,0%,127,0.82%
27137,Minnesota,St. Louis County,200319,100503,99816,93306,93077,92184,92131,184315,16004,No,7.99%,2921,1%,2660,1.33%
27139,Minnesota,Scott County,135152,67273,67879,59339,59454,56560,56858,113418,21734,No,16.08%,4135,3%,6251,4.63%
27141,Minnesota,Sherburne County,89455,45699,43756,42960,41740,41988,40985,82973,6482,No,7.25%,1730,2%,1982,2.22%
27143,Minnesota,Sibley County,15123,7598,7525,7433,7324,6878,6791,13669,1454,No,9.61%,63,0%,1166,7.71%
27145,Minnesota,Stearns County,151606,76472,75134,70576,69829,68536,68010,136546,15060,No,9.93%,5147,3%,4471,2.95%
27147,Minnesota,Steele County,36322,17976,18346,17022,17440,15806,16300,32106,4216,No,11.61%,982,3%,2483,6.84%
27149,Minnesota,Stevens County,9663,4804,4859,4553,4579,4342,4465,8807,856,No,8.86%,114,1%,373,3.86%
27151,Minnesota,Swift County,9594,4840,4754,4735,4598,4561,4451,9012,582,No,6.07%,77,1%,367,3.83%
27153,Minnesota,Todd County,24509,12581,11928,12181,11591,11573,11021,22594,1915,No,7.81%,121,0%,1293,5.28%
27155,Minnesota,Traverse County,3451,1706,1745,1598,1632,1580,1615,3195,256,No,7.42%,16,0%,53,1.54%
27157,Minnesota,Wabasha County,21476,10715,10761,10496,10515,10200,10285,20485,991,No,4.61%,107,0%,603,2.81%
27159,Minnesota,Wadena County,13767,6812,6955,6571,6705,6499,6616,13115,652,No,4.74%,129,1%,188,1.37%
27161,Minnesota,Waseca County,19237,9079,10158,8776,9439,8377,8822,17199,2038,No,10.59%,462,2%,1113,5.79%
27163,Minnesota,Washington County,244088,120888,123200,106050,109234,102060,105474,207534,36554,No,14.98%,9717,4%,8865,3.63%
27165,Minnesota,Watonwan County,11187,5593,5594,5374,5335,4253,4252,8505,2682,No,23.97%,137,1%,2411,21.55%
27167,Minnesota,Wilkin County,6585,3336,3249,3232,3157,3159,3083,6242,343,No,5.21%,20,0%,166,2.52%
27169,Minnesota,Winona County,51629,25371,26258,24037,24915,23371,24334,47705,3924,No,7.60%,655,1%,1366,2.65%
27171,Minnesota,Wright County,127336,64093,63243,61327,60499,59775,59036,118811,8525,No,6.69%,1421,1%,3428,2.69%
27173,Minnesota,Yellow Medicine County,10158,5188,4970,4901,4684,4707,4511,9218,940,No,9.25%,32,0%,429,4.22%
28001,Mississippi,Adams County,32122,16115,16007,7796,6489,5905,6374,12279,19843,Yes,61.77%,17235,54%,2314,7.20%
28003,Mississippi,Alcorn County,37164,18200,18964,15748,16328,15185,15971,31156,6008,No,16.17%,4495,12%,1017,2.74%
28005,Mississippi,Amite County,12957,6314,6643,3701,3753,3652,3714,7366,5591,No,43.15%,5364,41%,132,1.02%
28007,Mississippi,Attala County,19157,9105,10052,5313,5541,5171,5405,10576,8581,No,44.79%,8081,42%,333,1.74%
28009,Mississippi,Benton County,8730,4322,4408,2634,2718,2562,2653,5215,3515,No,40.26%,3260,37%,174,1.99%
28011,Mississippi,Bolivar County,33904,15783,18121,5586,5847,5343,5625,10968,22936,Yes,67.65%,21973,65%,691,2.04%
28013,Mississippi,Calhoun County,14843,7141,7702,5111,5297,4665,4978,9643,5200,No,35.03%,4236,29%,840,5.66%
28015,Mississippi,Carroll County,10423,5281,5142,3478,3327,3419,3298,6717,3706,No,35.56%,3491,33%,129,1.24%
28017,Mississippi,Chickasaw County,17416,8367,9049,4691,4919,4415,4694,9109,8307,No,47.70%,7529,43%,657,3.77%
28019,Mississippi,Choctaw County,8346,4069,4277,2798,2883,2759,2844,5603,2743,No,32.87%,2522,30%,114,1.37%
28021,Mississippi,Claiborne County,9349,4400,4949,706,668,686,660,1346,8003,Yes,85.60%,7852,84%,89,0.95%
28023,Mississippi,Clarke County,16556,7844,8712,5184,5459,5118,5390,10508,6048,No,36.53%,5713,35%,160,0.97%
28025,Mississippi,Clay County,20427,9619,10808,4053,4137,3973,4073,8046,12381,Yes,60.61%,12039,59%,231,1.13%
28027,Mississippi,Coahoma County,25709,11886,13823,2922,3112,2813,3020,5833,19876,Yes,77.31%,19348,75%,332,1.29%
28029,Mississippi,Copiah County,28955,14009,14946,6728,7011,6368,6759,13127,15828,Yes,54.66%,14805,51%,815,2.81%
28031,Mississippi,Covington County,19607,9590,10017,6158,6187,5987,6086,12073,7534,No,38.43%,7012,36%,402,2.05%
28033,Mississippi,DeSoto County,166234,80625,85609,60207,61870,56258,58592,114850,51384,No,30.91%,38963,23%,8136,4.89%
28035,Mississippi,Forrest County,76894,36725,40169,22735,23910,21515,22986,44501,32393,No,42.13%,28210,37%,2670,3.47%
28037,Mississippi,Franklin County,7918,3874,4044,2510,2539,2489,2516,5005,2913,No,36.79%,2787,35%,66,0.83%
28039,Mississippi,George County,22930,11648,11282,10399,10265,10116,10094,20210,2720,No,11.86%,1927,8%,485,2.12%
28041,Mississippi,Greene County,14311,8491,5820,5556,4708,5474,4672,10146,4165,No,29.10%,3865,27%,142,0.99%
28043,Mississippi,Grenada County,21682,10237,11445,5886,6348,5784,6269,12053,9629,No,44.41%,9125,42%,242,1.12%
28045,Mississippi,Hancock County,45255,22392,22863,19867,20196,19148,19601,38749,6506,No,14.38%,3544,8%,1550,3.43%
28047,Mississippi,Harrison County,194029,96405,97624,69243,67770,64267,64045,128312,65717,No,33.87%,45363,23%,10390,5.35%
28049,Mississippi,Hinds County,248643,116606,132037,33976,36236,32550,35067,67617,181026,Yes,72.81%,173598,70%,3903,1.57%
28051,Mississippi,Holmes County,18796,8842,9954,1491,1552,1468,1536,3004,15792,Yes,84.02%,15560,83%,149,0.79%
28053,Mississippi,Humphreys County,9189,4330,4859,1055,1139,975,1075,2050,7139,Yes,77.69%,6874,75%,216,2.35%
28055,Mississippi,Issaquena County,1386,830,556,250,230,243,227,470,916,Yes,66.09%,893,64%,11,0.79%
28057,Mississippi,Itawamba County,23340,11391,11949,10521,11062,10371,10933,21304,2036,No,8.72%,1491,6%,333,1.43%
28059,Mississippi,Jackson County,140298,69043,71255,51284,51865,47998,49200,97198,43100,No,30.72%,30948,22%,6894,4.91%
28061,Mississippi,Jasper County,16523,7975,8548,3818,3875,3770,3846,7616,8907,Yes,53.91%,8669,52%,145,0.88%
28063,Mississippi,Jefferson County,7638,3793,3845,545,513,538,509,1047,6591,Yes,86.29%,6522,85%,34,0.45%
28065,Mississippi,Jefferson Davis County,12032,5759,6273,2334,2379,2280,2350,4630,7402,Yes,61.52%,7164,60%,132,1.10%
28067,Mississippi,Jones County,68641,33382,35259,23441,24022,21909,22896,44805,23836,No,34.73%,19873,29%,3097,4.51%
28069,Mississippi,Kemper County,10335,5131,5204,1809,1822,1799,1805,3604,6731,Yes,65.13%,6238,60%,62,0.60%
28071,Mississippi,Lafayette County,49495,24231,25264,17781,17899,17328,17501,34829,14666,No,29.63%,11911,24%,1075,2.17%
28073,Mississippi,Lamar County,57786,27870,29916,21888,22713,21298,22156,43454,14332,No,24.80%,11638,20%,1325,2.29%
28075,Mississippi,Lauderdale County,80220,38862,41358,21760,22326,21117,21856,42973,37247,No,46.43%,34618,43%,1552,1.93%
28077,Mississippi,Lawrence County,12551,6125,6426,4240,4251,4104,4191,8295,4256,No,33.91%,3889,31%,261,2.08%
28079,Mississippi,Leake County,23297,11979,11318,5949,5913,5593,5656,11249,12048,Yes,51.71%,9563,41%,1010,4.34%
28081,Mississippi,Lee County,85042,40659,44383,28685,30537,27766,29801,57567,27475,No,32.31%,24024,28%,2042,2.40%
28083,Mississippi,Leflore County,30948,14405,16543,3865,4092,3616,3915,7531,23417,Yes,75.67%,22484,73%,750,2.42%
28085,Mississippi,Lincoln County,34900,16683,18217,11509,12230,11364,12098,23462,11438,No,32.77%,10683,31%,387,1.11%
28087,Mississippi,Lowndes County,59670,28304,31366,15747,16476,15345,16111,31456,28214,No,47.28%,26255,44%,1010,1.69%
28089,Mississippi,Madison County,98468,47208,51260,27871,29185,26745,28181,54926,43542,No,44.22%,38015,39%,2836,2.88%
28091,Mississippi,Marion County,26442,12753,13689,8424,9009,8260,8869,17129,9313,No,35.22%,8652,33%,363,1.37%
28093,Mississippi,Marshall County,36612,18131,18481,9499,9219,8896,8758,17654,18958,Yes,51.78%,17384,47%,1294,3.53%
28095,Mississippi,Monroe County,36421,17403,19018,11924,12826,11767,12717,24484,11937,No,32.78%,11197,31%,369,1.01%
28097,Mississippi,Montgomery County,10614,5072,5542,2758,2879,2712,2837,5549,5065,No,47.72%,4867,46%,119,1.12%
28099,Mississippi,Neshoba County,29785,14233,15552,8688,9386,8491,9225,17716,12069,No,40.52%,6341,21%,571,1.92%
28101,Mississippi,Newton County,21601,10338,11263,6714,7013,6581,6892,13473,8128,No,37.63%,6566,30%,339,1.57%
28103,Mississippi,Noxubee County,11218,5419,5799,1505,1523,1471,1493,2964,8254,Yes,73.58%,8059,72%,96,0.86%
28105,Mississippi,Oktibbeha County,48192,23983,24209,14821,13617,14510,13341,27851,20341,No,42.21%,17717,37%,764,1.59%
28107,Mississippi,Panola County,34473,16586,17887,8417,8516,8203,8356,16559,17914,Yes,51.97%,17035,49%,534,1.55%
28109,Mississippi,Pearl River County,55295,27267,28028,23166,23617,22374,22890,45264,10031,No,18.14%,7007,13%,1684,3.05%
28111,Mississippi,Perry County,12086,5904,6182,4636,4833,4585,4784,9369,2717,No,22.48%,2428,20%,118,0.98%
28113,Mississippi,Pike County,40100,19106,20994,8848,9529,8664,9388,18052,22048,Yes,54.98%,21043,52%,521,1.30%
28115,Mississippi,Pontotoc County,30594,15116,15478,12479,12853,11562,12223,23785,6809,No,22.26%,4531,15%,1897,6.20%
28117,Mississippi,Prentiss County,25390,12463,12927,10492,10874,10357,10763,21120,4270,No,16.82%,3620,14%,317,1.25%
28119,Mississippi,Quitman County,7798,3702,4096,1107,1184,1083,1169,2252,5546,Yes,71.12%,5394,69%,65,0.83%
28121,Mississippi,Rankin County,145165,70051,75114,54677,58402,52989,56981,109970,35195,No,24.24%,28448,20%,3686,2.54%
28123,Mississippi,Scott County,28250,13725,14525,8344,8381,6992,7318,14310,13940,No,49.35%,10765,38%,2996,10.61%
28125,Mississippi,Sharkey County,4799,2239,2560,659,705,637,689,1326,3473,Yes,72.37%,3391,71%,61,1.27%
28127,Mississippi,Simpson County,27374,13286,14088,8450,8761,8257,8639,16896,10478,No,38.28%,9733,36%,472,1.72%
28129,Mississippi,Smith County,16345,7892,8453,6048,6315,5964,6236,12200,4145,No,25.36%,3834,23%,217,1.33%
28131,Mississippi,Stone County,18028,9022,9006,7046,7066,6919,6949,13868,4160,No,23.08%,3571,20%,283,1.57%
28133,Mississippi,Sunflower County,28431,15029,13402,4074,3375,3936,3284,7220,21211,Yes,74.61%,20650,73%,397,1.40%
28135,Mississippi,Tallahatchie County,15111,8348,6763,3719,2531,2989,2508,5497,9614,Yes,63.62%,8525,56%,879,5.82%
28137,Mississippi,Tate County,28490,13622,14868,9416,9844,9116,9595,18711,9779,No,34.32%,8728,31%,686,2.41%
28139,Mississippi,Tippah County,22025,10803,11222,8903,9163,8394,8735,17129,4896,No,22.23%,3538,16%,1076,4.89%
28141,Mississippi,Tishomingo County,19591,9473,10118,9075,9691,8812,9485,18297,1294,No,6.61%,548,3%,538,2.75%
28143,Mississippi,Tunica County,10475,4984,5491,1255,1239,1140,1184,2324,8151,Yes,77.81%,7797,74%,221,2.11%
28145,Mississippi,Union County,27414,13391,14023,11202,11650,10574,11200,21774,5640,No,20.57%,4095,15%,1222,4.46%
28147,Mississippi,Walthall County,15100,7334,7766,3988,4122,3888,4059,7947,7153,No,47.37%,6702,44%,253,1.68%
28149,Mississippi,Warren County,48084,22887,25197,11859,12356,11477,12040,23517,24567,Yes,51.09%,22892,48%,919,1.91%
28151,Mississippi,Washington County,49750,23148,26602,6628,6918,6427,6764,13191,36559,Yes,73.49%,35467,71%,625,1.26%
28153,Mississippi,Wayne County,20661,9918,10743,6062,6298,5945,6227,12172,8489,No,41.09%,8034,39%,273,1.32%
28155,Mississippi,Webster County,10039,4922,5117,3885,4015,3824,3966,7790,2249,No,22.40%,2002,20%,134,1.33%
28157,Mississippi,Wilkinson County,9432,4995,4437,1490,1276,1481,1267,2748,6684,Yes,70.87%,6604,70%,45,0.48%
28159,Mississippi,Winston County,19029,9264,9765,4863,5008,4778,4951,9729,9300,No,48.87%,8750,46%,189,0.99%
28161,Mississippi,Yalobusha County,12401,5977,6424,3691,3823,3612,3764,7376,5025,No,40.52%,4705,38%,186,1.50%
28163,Mississippi,Yazoo County,28195,15655,12540,6677,4930,5484,4870,10354,17841,Yes,63.28%,16098,57%,1516,5.38%
29001,Missouri,Adair County,25581,12215,13366,11486,12624,11257,12347,23604,1977,No,7.73%,417,2%,577,2.26%
29003,Missouri,Andrew County,17417,8566,8851,8340,8611,8163,8491,16654,763,No,4.38%,105,1%,342,1.96%
29005,Missouri,Atchison County,5517,2736,2781,2673,2700,2649,2676,5325,192,No,3.48%,65,1%,55,1.00%
29007,Missouri,Audrain County,25621,11732,13889,10744,12474,10385,12200,22585,3036,No,11.85%,1726,7%,709,2.77%
29009,Missouri,Barry County,35546,17615,17931,16806,17112,15456,15851,31307,4239,No,11.93%,141,0%,2845,8.00%
29011,Missouri,Barton County,12337,6046,6291,5773,6003,5670,5895,11565,772,No,6.26%,56,0%,287,2.33%
29013,Missouri,Bates County,16709,8237,8472,7946,8226,7796,8105,15901,808,No,4.84%,159,1%,314,1.88%
29015,Missouri,Benton County,18962,9506,9456,9238,9181,9081,9067,18148,814,No,4.29%,71,0%,306,1.61%
29017,Missouri,Bollinger County,12382,6197,6185,6074,6049,6029,5998,12027,355,No,2.87%,41,0%,108,0.87%
29019,Missouri,Boone County,168535,81617,86918,68013,72330,65785,70227,136012,32523,No,19.30%,15828,9%,5219,3.10%
29021,Missouri,Buchanan County,89706,44996,44710,40095,40918,37665,38878,76543,13163,No,14.67%,5082,6%,5107,5.69%
29023,Missouri,Butler County,43053,20866,22187,18962,20189,18683,19926,38609,4444,No,10.32%,2403,6%,683,1.59%
29025,Missouri,Caldwell County,9145,4598,4547,4444,4423,4356,4365,8721,424,No,4.64%,56,1%,165,1.80%
29027,Missouri,Callaway County,44305,22669,21636,20748,20209,20410,19931,40341,3964,No,8.95%,1996,5%,756,1.71%
29029,Missouri,Camden County,43845,21730,22115,21123,21465,20635,20996,41631,2214,No,5.05%,234,1%,1072,2.44%
29031,Missouri,Cape Girardeau County,76950,37154,39796,33263,35483,32613,34795,67408,9542,No,12.40%,5656,7%,1622,2.11%
29033,Missouri,Carroll County,9086,4452,4634,4257,4469,4192,4433,8625,461,No,5.07%,192,2%,115,1.27%
29035,Missouri,Carter County,6262,3037,3225,2934,3100,2884,3048,5932,330,No,5.27%,22,0%,128,2.04%
29037,Missouri,Cass County,100376,49066,51310,45601,47714,43698,45992,89690,10686,No,10.65%,3800,4%,4097,4.08%
29039,Missouri,Cedar County,13799,6852,6947,6659,6735,6555,6639,13194,605,No,4.38%,32,0%,239,1.73%
29041,Missouri,Chariton County,7649,3777,3872,3651,3732,3625,3715,7340,309,No,4.04%,170,2%,53,0.69%
29043,Missouri,Christian County,79824,38870,40954,37356,39420,36367,38544,74911,4913,No,6.15%,574,1%,2151,2.69%
29045,Missouri,Clark County,6969,3514,3455,3447,3387,3423,3358,6781,188,No,2.70%,15,0%,58,0.83%
29047,Missouri,Clay County,227577,111363,116214,98798,103388,92537,97320,189857,37720,No,16.57%,12908,6%,14045,6.17%
29049,Missouri,Clinton County,20508,10386,10122,9910,9696,9735,9549,19284,1224,No,5.97%,327,2%,370,1.80%
29051,Missouri,Cole County,76363,38512,37851,32097,32774,31275,31952,63227,13136,No,17.20%,8804,12%,2000,2.62%
29053,Missouri,Cooper County,17520,9229,8291,8091,7701,7991,7612,15603,1917,No,10.94%,1236,7%,246,1.40%
29055,Missouri,Crawford County,24832,12345,12487,12020,12189,11825,12028,23853,979,No,3.94%,93,0%,400,1.61%
29057,Missouri,Dade County,7568,3809,3759,3644,3611,3594,3557,7151,417,No,5.51%,36,0%,122,1.61%
29059,Missouri,Dallas County,16799,8371,8428,8101,8153,7972,8032,16004,795,No,4.73%,46,0%,292,1.74%
29061,Missouri,Daviess County,8239,4119,4120,4020,4042,3981,3998,7979,260,No,3.16%,37,0%,99,1.20%
29063,Missouri,DeKalb County,12940,8131,4809,6552,4680,6389,4619,11008,1932,No,14.93%,1472,11%,252,1.95%
29065,Missouri,Dent County,15647,7730,7917,7436,7644,7342,7561,14903,744,No,4.75%,74,0%,196,1.25%
29067,Missouri,Douglas County,13585,6718,6867,6525,6646,6473,6586,13059,526,No,3.87%,48,0%,133,0.98%
29069,Missouri,Dunklin County,31826,15258,16568,13410,14485,12524,13634,26158,5668,No,17.81%,3220,10%,1873,5.89%
29071,Missouri,Franklin County,101412,50343,51069,48857,49596,48128,48942,97070,4342,No,4.28%,952,1%,1531,1.51%
29073,Missouri,Gasconade County,14972,7373,7599,7217,7430,7128,7359,14487,485,No,3.24%,47,0%,181,1.21%
29075,Missouri,Gentry County,6777,3272,3505,3210,3442,3193,3420,6613,164,No,2.42%,31,0%,48,0.71%
29077,Missouri,Greene County,280626,136787,143839,124777,132764,120824,129123,249947,30679,No,10.93%,8572,3%,8985,3.20%
29079,Missouri,Grundy County,10338,4926,5412,4793,5261,4703,5181,9884,454,No,4.39%,74,1%,190,1.84%
29081,Missouri,Harrison County,8728,4377,4351,4275,4232,4208,4180,8388,340,No,3.90%,45,1%,153,1.75%
29083,Missouri,Henry County,22153,10830,11323,10429,10910,10246,10732,20978,1175,No,5.30%,260,1%,411,1.86%
29085,Missouri,Hickory County,9391,4598,4793,4464,4633,4415,4588,9003,388,No,4.13%,33,0%,103,1.10%
29087,Missouri,Holt County,4655,2298,2357,2240,2297,2224,2278,4502,153,No,3.29%,9,0%,39,0.84%
29089,Missouri,Howard County,10169,5014,5155,4621,4738,4572,4682,9254,915,No,9.00%,545,5%,131,1.29%
29091,Missouri,Howell County,40629,19746,20883,19121,20169,18783,19894,38677,1952,No,4.80%,172,0%,704,1.73%
29093,Missouri,Iron County,10374,5098,5276,4900,5076,4837,5016,9853,521,No,5.02%,155,1%,140,1.35%
29095,Missouri,Jackson County,677377,327483,349894,234436,243082,208904,219163,428067,249310,No,36.81%,163134,24%,57553,8.50%
29097,Missouri,Jasper County,115258,56488,58770,51499,54131,47978,50950,98928,16330,No,14.17%,2551,2%,8122,7.05%
29099,Missouri,Jefferson County,220209,109321,110888,105761,107242,104028,105718,209746,10463,No,4.75%,2068,1%,3615,1.64%
29101,Missouri,Johnson County,54397,27734,26663,24946,24087,24082,23291,47373,7024,No,12.91%,2522,5%,1934,3.56%
29103,Missouri,Knox County,4082,2022,2060,1973,2019,1951,1992,3943,139,No,3.41%,15,0%,51,1.25%
29105,Missouri,Laclede County,35417,17476,17941,16769,17299,16432,16976,33408,2009,No,5.67%,260,1%,735,2.08%
29107,Missouri,Lafayette County,33080,16359,16721,15432,15890,15070,15565,30635,2445,No,7.39%,771,2%,801,2.42%
29109,Missouri,Lawrence County,38467,19006,19461,18318,18766,17121,17645,34766,3701,No,9.62%,155,0%,2578,6.70%
29111,Missouri,Lewis County,10174,5095,5079,4799,4808,4713,4750,9463,711,No,6.99%,356,3%,167,1.64%
29113,Missouri,Lincoln County,53354,26711,26643,25492,25527,24994,25050,50044,3310,No,6.20%,1041,2%,1119,2.10%
29115,Missouri,Linn County,12484,6015,6469,5846,6320,5746,6213,11959,525,No,4.21%,96,1%,234,1.87%
29117,Missouri,Livingston County,15037,6700,8337,6480,7843,6388,7752,14140,897,No,5.97%,428,3%,198,1.32%
29119,Missouri,McDonald County,22876,11548,11328,10337,10224,9123,9137,18260,4616,No,20.18%,317,1%,2555,11.17%
29121,Missouri,Macon County,15573,7643,7930,7261,7569,7193,7491,14684,889,No,5.71%,364,2%,184,1.18%
29123,Missouri,Madison County,12448,6099,6349,5942,6206,5819,6127,11946,502,No,4.03%,57,0%,232,1.86%
29125,Missouri,Maries County,9014,4514,4500,4406,4401,4358,4365,8723,291,No,3.23%,36,0%,95,1.05%
29127,Missouri,Marion County,28745,13896,14849,12771,13655,12596,13491,26087,2658,No,9.25%,1482,5%,415,1.44%
29129,Missouri,Mercer County,3729,1856,1873,1811,1822,1796,1811,3607,122,No,3.27%,9,0%,37,0.99%
29131,Missouri,Miller County,24817,12364,12453,11944,12063,11770,11903,23673,1144,No,4.61%,149,1%,394,1.59%
29133,Missouri,Mississippi County,14322,7664,6658,5422,5208,5276,5121,10397,3925,No,27.41%,3481,24%,274,1.91%
29135,Missouri,Moniteau County,15625,8250,7375,7528,7199,7168,6921,14089,1536,No,9.83%,587,4%,666,4.26%
29137,Missouri,Monroe County,8703,4362,4341,4150,4110,4114,4064,8178,525,No,6.03%,254,3%,90,1.03%
29139,Missouri,Montgomery County,11996,5986,6010,5744,5804,5641,5745,11386,610,No,5.09%,206,2%,184,1.53%
29141,Missouri,Morgan County,20117,10081,10036,9713,9669,9553,9529,19082,1035,No,5.14%,164,1%,382,1.90%
29143,Missouri,New Madrid County,18488,8824,9664,7284,7818,7181,7731,14912,3576,No,19.34%,2952,16%,248,1.34%
29145,Missouri,Newton County,59069,29262,29807,26630,27365,25374,26179,51553,7516,No,12.72%,556,1%,2844,4.81%
29147,Missouri,Nodaway County,23419,11838,11581,11042,11084,10878,10964,21842,1577,No,6.73%,616,3%,325,1.39%
29149,Missouri,Oregon County,10997,5434,5563,5240,5345,5176,5269,10445,552,No,5.02%,35,0%,159,1.45%
29151,Missouri,Osage County,13858,7214,6644,7131,6554,7095,6510,13605,253,No,1.83%,44,0%,92,0.66%
29153,Missouri,Ozark County,9601,4822,4779,4689,4665,4633,4598,9231,370,No,3.85%,26,0%,148,1.54%
29155,Missouri,Pemiscot County,18111,8584,9527,6184,6690,6003,6536,12539,5572,No,30.77%,4866,27%,411,2.27%
29157,Missouri,Perry County,19018,9517,9501,9257,9283,9087,9153,18240,778,No,4.09%,95,0%,376,1.98%
29159,Missouri,Pettis County,42319,20865,21454,19415,20059,17853,18710,36563,5756,No,13.60%,1380,3%,3243,7.66%
29161,Missouri,Phelps County,44987,23495,21492,21293,19846,20864,19470,40334,4653,No,10.34%,1087,2%,987,2.19%
29163,Missouri,Pike County,18565,10226,8339,8937,7911,8718,7772,16490,2075,No,11.18%,1400,8%,378,2.04%
29165,Missouri,Platte County,92054,45365,46689,39803,41271,37601,39186,76787,15267,No,16.58%,5732,6%,4966,5.39%
29167,Missouri,Polk County,31017,15254,15763,14700,15199,14434,14908,29342,1675,No,5.40%,273,1%,618,1.99%
29169,Missouri,Pulaski County,53259,29946,23313,23818,18383,21359,16782,38141,15118,No,28.39%,6330,12%,5160,9.69%
29171,Missouri,Putnam County,4931,2482,2449,2435,2403,2412,2387,4799,132,No,2.68%,10,0%,43,0.87%
29173,Missouri,Ralls County,10277,5191,5086,5035,4949,4980,4890,9870,407,No,3.96%,121,1%,129,1.26%
29175,Missouri,Randolph County,25330,13280,12050,11884,11168,11674,11028,22702,2628,No,10.38%,1542,6%,430,1.70%
29177,Missouri,Ray County,23064,11471,11593,11023,11154,10851,10918,21769,1295,No,5.61%,306,1%,495,2.15%
29179,Missouri,Reynolds County,6667,3429,3238,3312,3131,3276,3099,6375,292,No,4.38%,49,1%,78,1.17%
29181,Missouri,Ripley County,14036,6907,7129,6678,6896,6584,6836,13420,616,No,4.39%,61,0%,182,1.30%
29183,Missouri,St. Charles County,368666,180897,187769,165029,171320,159981,166676,326657,42009,No,11.39%,16231,4%,10980,2.98%
29185,Missouri,St. Clair County,9474,4768,4706,4577,4568,4504,4496,9000,474,No,5.00%,59,1%,173,1.83%
29186,Missouri,Ste. Genevieve County,17740,8969,8771,8741,8579,8677,8506,17183,557,No,3.14%,125,1%,151,0.85%
29187,Missouri,St. Francois County,65917,35201,30716,31930,29800,31485,29486,60971,4946,No,7.50%,2931,4%,865,1.31%
29189,Missouri,St. Louis County,1000438,473646,526792,339466,365812,328107,355008,683115,317323,No,31.72%,236396,24%,26512,2.65%
29195,Missouri,Saline County,23339,11544,11795,10342,10685,9368,9783,19151,4188,No,17.94%,1289,6%,2122,9.09%
29197,Missouri,Schuyler County,4370,2123,2247,2094,2220,2074,2206,4280,90,No,2.06%,6,0%,37,0.85%
29199,Missouri,Scotland County,4877,2384,2493,2363,2459,2354,2435,4789,88,No,1.80%,3,0%,33,0.68%
29201,Missouri,Scott County,39139,18939,20200,16439,17334,16075,17058,33133,6006,No,15.35%,4488,11%,764,1.95%
29203,Missouri,Shannon County,8318,4134,4184,3979,4017,3927,3947,7874,444,No,5.34%,27,0%,140,1.68%
29205,Missouri,Shelby County,6234,3065,3169,3010,3104,2978,3072,6050,184,No,2.95%,40,1%,70,1.12%
29207,Missouri,Stoddard County,29795,14464,15331,14039,14927,13851,14770,28621,1174,No,3.94%,307,1%,413,1.39%
29209,Missouri,Stone County,31568,15506,16062,15101,15584,14854,15312,30166,1402,No,4.44%,103,0%,607,1.92%
29211,Missouri,Sullivan County,6546,3306,3240,3206,3149,2570,2652,5222,1324,No,20.23%,63,1%,1201,18.35%
29213,Missouri,Taney County,52956,25737,27219,24353,25863,23147,24675,47822,5134,No,9.69%,689,1%,2772,5.23%
29215,Missouri,Texas County,25810,13390,12420,12179,11952,11952,11759,23711,2099,No,8.13%,899,3%,497,1.93%
29217,Missouri,Vernon County,20748,10090,10658,9705,10265,9546,10102,19648,1100,No,5.30%,144,1%,381,1.84%
29219,Missouri,Warren County,32753,16264,16489,15452,15707,14975,15337,30312,2441,No,7.45%,713,2%,980,2.99%
29221,Missouri,Washington County,25095,12935,12160,12174,11853,12030,11751,23781,1314,No,5.24%,586,2%,300,1.20%
29223,Missouri,Wayne County,13402,6674,6728,6483,6534,6408,6467,12875,527,No,3.93%,70,1%,169,1.26%
29225,Missouri,Webster County,36351,18431,17920,17663,17419,17397,17145,34542,1809,No,4.98%,366,1%,653,1.80%
29227,Missouri,Worth County,2079,1020,1059,999,1035,983,1031,2014,65,No,3.13%,17,1%,24,1.15%
29229,Missouri,Wright County,18629,9123,9506,8868,9232,8741,9091,17832,797,No,4.28%,100,1%,293,1.57%
29510,Missouri,St. Louis city,318172,153666,164506,73671,72383,68577,68020,136597,181575,Yes,57.07%,154406,49%,11598,3.65%
30001,Montana,Beaverhead County,9346,4784,4562,4541,4344,4349,4211,8560,786,No,8.41%,76,1%,362,3.87%
30003,Montana,Big Horn County,13061,6483,6578,2129,2030,1993,1916,3909,9152,Yes,70.07%,50,0%,611,4.68%
30005,Montana,Blaine County,6683,3322,3361,1597,1615,1573,1591,3164,3519,Yes,52.66%,14,0%,138,2.06%
30007,Montana,Broadwater County,5756,2946,2810,2833,2710,2773,2641,5414,342,No,5.94%,25,0%,143,2.48%
30009,Montana,Carbon County,10127,5107,5020,4967,4870,4864,4777,9641,486,No,4.80%,50,0%,226,2.23%
30011,Montana,Carter County,1177,597,580,589,568,587,563,1150,27,No,2.29%,1,0%,8,0.68%
30013,Montana,Cascade County,81723,41015,40708,36763,36430,35552,35354,70906,10817,No,13.24%,1172,1%,3065,3.75%
30015,Montana,Chouteau County,5904,2933,2971,2287,2275,2267,2247,4514,1390,No,23.54%,10,0%,109,1.85%
30017,Montana,Custer County,11888,5930,5958,5663,5682,5541,5570,11111,777,No,6.54%,58,0%,295,2.48%
30019,Montana,Daniels County,1786,898,888,863,847,850,830,1680,106,No,5.94%,4,0%,34,1.90%
30021,Montana,Dawson County,9249,4716,4533,4476,4358,4376,4275,8651,598,No,6.47%,32,0%,238,2.57%
30023,Montana,Deer Lodge County,9227,4884,4343,4501,4091,4388,4015,8403,824,No,8.93%,43,0%,269,2.92%
30025,Montana,Fallon County,3024,1530,1494,1486,1462,1465,1442,2907,117,No,3.87%,7,0%,46,1.52%
30027,Montana,Fergus County,11435,5750,5685,5545,5486,5463,5394,10857,578,No,5.05%,40,0%,209,1.83%
30029,Montana,Flathead County,91633,45668,45965,43697,43907,42759,42963,85722,5911,No,6.45%,327,0%,2271,2.48%
30031,Montana,Gallatin County,92614,47865,44749,45717,42694,44520,41570,86090,6524,No,7.04%,411,0%,2671,2.88%
30033,Montana,Garfield County,1261,626,635,613,622,610,618,1228,33,No,2.62%,3,0%,7,0.56%
30035,Montana,Glacier County,13711,6753,6958,2177,2285,2121,2233,4354,9357,Yes,68.24%,32,0%,316,2.30%
30037,Montana,Golden Valley County,839,437,402,419,383,403,377,780,59,No,7.03%,4,0%,29,3.46%
30039,Montana,Granite County,3109,1581,1528,1533,1474,1511,1448,2959,150,No,4.82%,14,0%,54,1.74%
30041,Montana,Hill County,16366,8268,8098,6140,5858,6019,5730,11749,4617,No,28.21%,68,0%,439,2.68%
30043,Montana,Jefferson County,11401,5790,5611,5547,5323,5448,5224,10672,729,No,6.39%,45,0%,220,1.93%
30045,Montana,Judith Basin County,2024,1056,968,1037,947,1027,930,1957,67,No,3.31%,3,0%,27,1.33%
30047,Montana,Lake County,28986,14268,14718,9849,10117,9590,9829,19419,9567,No,33.01%,122,0%,1081,3.73%
30049,Montana,Lewis and Clark County,64876,32041,32835,30170,30946,29488,30191,59679,5197,No,8.01%,439,1%,1747,2.69%
30051,Montana,Liberty County,2392,1152,1240,1134,1217,1121,1213,2334,58,No,2.42%,3,0%,17,0.71%
30053,Montana,Lincoln County,19491,9866,9625,9514,9182,9289,8955,18244,1247,No,6.40%,61,0%,512,2.63%
30055,Montana,McCone County,1701,864,837,844,815,840,803,1643,58,No,3.41%,9,1%,17,1.00%
30057,Montana,Madison County,7733,4008,3725,3898,3604,3802,3514,7316,417,No,5.39%,42,1%,211,2.73%
30059,Montana,Meagher County,1924,991,933,971,906,961,893,1854,70,No,3.64%,8,0%,27,1.40%
30061,Montana,Mineral County,4167,2165,2002,2052,1886,2000,1839,3839,328,No,7.87%,20,0%,107,2.57%
30063,Montana,Missoula County,110977,55787,55190,51846,51124,50622,49884,100506,10471,No,9.44%,571,1%,3088,2.78%
30065,Montana,Musselshell County,4665,2328,2337,2243,2241,2193,2188,4381,284,No,6.09%,24,1%,126,2.70%
30067,Montana,Park County,15567,7773,7794,7521,7503,7361,7340,14701,866,No,5.56%,33,0%,386,2.48%
30069,Montana,Petroleum County,511,274,237,273,234,270,232,502,9,No,1.76%,0,0%,5,0.98%
30071,Montana,Phillips County,4128,2057,2071,1819,1801,1785,1764,3549,579,No,14.03%,2,0%,91,2.20%
30073,Montana,Pondera County,6165,3003,3162,2486,2606,2463,2580,5043,1122,No,18.20%,16,0%,90,1.46%
30075,Montana,Powder River County,1763,907,856,877,818,864,805,1669,94,No,5.33%,1,0%,29,1.64%
30077,Montana,Powell County,7096,4384,2712,3968,2582,3880,2542,6422,674,No,9.50%,82,1%,156,2.20%
30079,Montana,Prairie County,1157,588,569,570,537,559,527,1086,71,No,6.14%,0,0%,21,1.82%
30081,Montana,Ravalli County,40617,20155,20462,19354,19676,18866,19103,37969,2648,No,6.52%,140,0%,1259,3.10%
30083,Montana,Richland County,10810,5648,5162,5421,4926,5207,4752,9959,851,No,7.87%,28,0%,425,3.93%
30085,Montana,Roosevelt County,10927,5386,5541,1993,2017,1955,1981,3936,6991,Yes,63.98%,25,0%,195,1.78%
30087,Montana,Rosebud County,9396,4737,4659,2929,2807,2839,2740,5579,3817,No,40.62%,29,0%,344,3.66%
30089,Montana,Sanders County,11408,5819,5589,5330,5160,5219,5049,10268,1140,No,9.99%,38,0%,286,2.51%
30091,Montana,Sheridan County,3580,1826,1754,1746,1669,1724,1644,3368,212,No,5.92%,14,0%,60,1.68%
30093,Montana,Silver Bow County,34403,17455,16948,16524,16087,15988,15570,31558,2845,No,8.27%,146,0%,1326,3.85%
30095,Montana,Stillwater County,9195,4704,4491,4559,4335,4456,4219,8675,520,No,5.66%,45,0%,262,2.85%
30097,Montana,Sweet Grass County,3605,1812,1793,1755,1731,1731,1703,3434,171,No,4.74%,10,0%,59,1.64%
30099,Montana,Teton County,6053,2986,3067,2870,2955,2826,2913,5739,314,No,5.19%,8,0%,93,1.54%
30101,Montana,Toole County,5220,2918,2302,2636,2144,2551,2088,4639,581,No,11.13%,34,1%,166,3.18%
30103,Montana,Treasure County,736,371,365,355,341,341,333,674,62,No,8.42%,1,0%,28,3.80%
30105,Montana,Valley County,7505,3761,3744,3291,3273,3238,3233,6471,1034,No,13.78%,19,0%,119,1.59%
30107,Montana,Wheatland County,2104,1033,1071,988,1032,973,1017,1990,114,No,5.42%,9,0%,34,1.62%
30109,Montana,Wibaux County,1057,541,516,530,500,524,486,1010,47,No,4.45%,5,0%,22,2.08%
30111,Montana,Yellowstone County,151882,74402,77480,67999,70872,64968,68021,132989,18893,No,12.44%,1206,1%,7376,4.86%
31001,Nebraska,Adams County,31459,15711,15748,14947,15092,13707,14092,27799,3660,No,11.63%,284,1%,2531,8.05%
31003,Nebraska,Antelope County,6545,3236,3309,3190,3261,3105,3175,6280,265,No,4.05%,19,0%,184,2.81%
31005,Nebraska,Arthur County,486,239,247,231,237,221,234,455,31,No,6.38%,3,1%,21,4.32%
31007,Nebraska,Banner County,760,395,365,389,363,374,352,726,34,No,4.47%,0,0%,26,3.42%
31009,Nebraska,Blaine County,514,273,241,271,237,270,237,507,7,No,1.36%,1,0%,1,0.19%
31011,Nebraska,Boone County,5417,2727,2690,2680,2650,2651,2624,5275,142,No,2.62%,25,0%,64,1.18%
31013,Nebraska,Box Butte County,11317,5639,5678,5249,5248,4726,4772,9498,1819,No,16.07%,64,1%,1207,10.67%
31015,Nebraska,Boyd County,2054,1007,1047,981,1018,969,1002,1971,83,No,4.04%,4,0%,39,1.90%
31017,Nebraska,Brown County,3023,1459,1564,1438,1533,1421,1517,2938,85,No,2.81%,5,0%,33,1.09%
31019,Nebraska,Buffalo County,47463,23523,23940,22473,23119,20636,21471,42107,5356,No,11.28%,435,1%,3761,7.92%
31021,Nebraska,Burt County,6659,3268,3391,3147,3248,3079,3177,6256,403,No,6.05%,33,0%,183,2.75%
31023,Nebraska,Butler County,8295,4207,4088,4123,4025,4004,3924,7928,367,No,4.42%,40,0%,233,2.81%
31025,Nebraska,Cass County,25133,12634,12499,12306,12155,11990,11865,23855,1278,No,5.08%,108,0%,699,2.78%
31027,Nebraska,Cedar County,8746,4413,4333,4358,4272,4296,4225,8521,225,No,2.57%,10,0%,123,1.41%
31029,Nebraska,Chase County,4064,1993,2071,1967,2056,1718,1817,3535,529,No,13.02%,9,0%,492,12.11%
31031,Nebraska,Cherry County,5727,2859,2868,2612,2602,2562,2571,5133,594,No,10.37%,19,0%,114,1.99%
31033,Nebraska,Cheyenne County,10068,5012,5056,4781,4860,4503,4572,9075,993,No,9.86%,33,0%,636,6.32%
31035,Nebraska,Clay County,6411,3207,3204,3111,3098,2895,2886,5781,630,No,9.83%,40,1%,518,8.08%
31037,Nebraska,Colfax County,10653,5515,5138,5027,4792,2930,2876,5806,4847,No,45.50%,263,2%,4561,42.81%
31039,Nebraska,Cuming County,9072,4507,4565,4408,4456,4042,4109,8151,921,No,10.15%,30,0%,787,8.68%
31041,Nebraska,Custer County,10740,5339,5401,5234,5296,5114,5183,10297,443,No,4.12%,44,0%,251,2.34%
31043,Nebraska,Dakota County,20918,10489,10429,9151,9137,5422,5746,11168,9750,No,46.61%,833,4%,7609,36.38%
31045,Nebraska,Dawes County,9152,4585,4567,4076,4163,3934,4014,7948,1204,No,13.16%,143,2%,360,3.93%
31047,Nebraska,Dawson County,24220,12325,11895,11227,11066,7456,7655,15111,9109,No,37.61%,989,4%,7803,32.22%
31049,Nebraska,Deuel County,1972,965,1007,953,984,909,937,1846,126,No,6.39%,3,0%,102,5.17%
31051,Nebraska,Dixon County,5918,2945,2973,2873,2897,2547,2598,5145,773,No,13.06%,33,1%,668,11.29%
31053,Nebraska,Dodge County,36427,17852,18575,17100,17919,15335,16321,31656,4771,No,13.10%,325,1%,3819,10.48%
31055,Nebraska,Douglas County,531265,261243,270022,213680,219864,185452,194468,379920,151345,No,28.49%,62152,12%,61859,11.64%
31057,Nebraska,Dundy County,2021,1019,1002,986,971,923,915,1838,183,No,9.05%,9,0%,135,6.68%
31059,Nebraska,Fillmore County,5771,2840,2931,2783,2852,2700,2769,5469,302,No,5.23%,47,1%,192,3.33%
31061,Nebraska,Franklin County,3188,1602,1586,1571,1556,1554,1540,3094,94,No,2.95%,5,0%,43,1.35%
31063,Nebraska,Frontier County,2741,1405,1336,1387,1318,1373,1296,2669,72,No,2.63%,3,0%,39,1.42%
31065,Nebraska,Furnas County,4907,2404,2503,2351,2454,2272,2399,4671,236,No,4.81%,15,0%,149,3.04%
31067,Nebraska,Gage County,21806,10741,11065,10413,10765,10235,10582,20817,989,No,4.54%,100,0%,425,1.95%
31069,Nebraska,Garden County,1953,997,956,977,938,925,916,1841,112,No,5.73%,4,0%,79,4.05%
31071,Nebraska,Garfield County,2007,987,1020,980,1011,973,1002,1975,32,No,1.59%,4,0%,17,0.85%
31073,Nebraska,Gosper County,2029,1033,996,1010,967,975,933,1908,121,No,5.96%,9,0%,71,3.50%
31075,Nebraska,Grant County,629,338,291,335,285,331,283,614,15,No,2.38%,1,0%,7,1.11%
31077,Nebraska,Greeley County,2458,1250,1208,1229,1184,1205,1163,2368,90,No,3.66%,18,1%,52,2.12%
31079,Nebraska,Hall County,60345,30245,30100,27926,28176,20718,21941,42659,17686,No,29.31%,1437,2%,15013,24.88%
31081,Nebraska,Hamilton County,9011,4487,4524,4417,4459,4299,4350,8649,362,No,4.02%,25,0%,238,2.64%
31083,Nebraska,Harlan County,3410,1762,1648,1742,1622,1709,1596,3305,105,No,3.08%,4,0%,67,1.96%
31085,Nebraska,Hayes County,953,507,446,503,436,478,427,905,48,No,5.04%,4,0%,35,3.67%
31087,Nebraska,Hitchcock County,2887,1464,1423,1439,1396,1410,1369,2779,108,No,3.74%,6,0%,63,2.18%
31089,Nebraska,Holt County,10396,5154,5242,5067,5168,4902,5007,9909,487,No,4.68%,21,0%,365,3.51%
31091,Nebraska,Hooker County,727,353,374,343,368,342,362,704,23,No,3.16%,0,0%,7,0.96%
31093,Nebraska,Howard County,6336,3205,3131,3144,3057,3089,3000,6089,247,No,3.90%,26,0%,136,2.15%
31095,Nebraska,Jefferson County,7521,3725,3796,3637,3711,3521,3600,7121,400,No,5.32%,37,0%,252,3.35%
31097,Nebraska,Johnson County,5140,2960,2180,2564,2118,2255,1944,4199,941,No,18.31%,281,5%,503,9.79%
31099,Nebraska,Kearney County,6485,3169,3316,3108,3247,2989,3110,6099,386,No,5.95%,16,0%,288,4.44%
31101,Nebraska,Keith County,8220,4086,4134,3971,4012,3773,3783,7556,664,No,8.08%,29,0%,489,5.95%
31103,Nebraska,Keya Paha County,804,402,402,397,398,395,398,793,11,No,1.37%,1,0%,4,0.50%
31105,Nebraska,Kimball County,3783,1889,1894,1806,1807,1669,1695,3364,419,No,11.08%,8,0%,293,7.75%
31107,Nebraska,Knox County,8573,4191,4382,3704,3870,3641,3826,7467,1106,No,12.90%,16,0%,196,2.29%
31109,Nebraska,Lancaster County,293407,146933,146474,130403,131266,122249,123955,246204,47203,No,16.09%,10771,4%,18106,6.17%
31111,Nebraska,Lincoln County,36099,17869,18230,17191,17593,15905,16386,32291,3808,No,10.55%,320,1%,2791,7.73%
31113,Nebraska,Logan County,765,366,399,358,391,354,381,735,30,No,3.92%,3,0%,14,1.83%
31115,Nebraska,Loup County,589,298,291,294,290,288,282,570,19,No,3.23%,4,1%,14,2.38%
31117,Nebraska,McPherson County,509,251,258,247,252,246,250,496,13,No,2.55%,2,0%,3,0.59%
31119,Nebraska,Madison County,35031,17417,17614,16456,16698,14190,14757,28947,6084,No,17.37%,562,2%,4711,13.45%
31121,Nebraska,Merrick County,7780,3876,3904,3764,3795,3606,3673,7279,501,No,6.44%,26,0%,302,3.88%
31123,Nebraska,Morrill County,4889,2485,2404,2405,2310,2071,2014,4085,804,No,16.45%,15,0%,687,14.05%
31125,Nebraska,Nance County,3715,1861,1854,1820,1811,1782,1769,3551,164,No,4.41%,14,0%,105,2.83%
31127,Nebraska,Nemaha County,7154,3530,3624,3413,3511,3348,3448,6796,358,No,5.00%,74,1%,154,2.15%
31129,Nebraska,Nuckolls County,4438,2201,2237,2165,2188,2120,2142,4262,176,No,3.97%,9,0%,96,2.16%
31131,Nebraska,Otoe County,15747,7732,8015,7486,7797,7019,7348,14367,1380,No,8.76%,103,1%,981,6.23%
31133,Nebraska,Pawnee County,2765,1393,1372,1361,1337,1334,1318,2652,113,No,4.09%,11,0%,50,1.81%
31135,Nebraska,Perkins County,2931,1483,1448,1466,1420,1422,1378,2800,131,No,4.47%,21,1%,98,3.34%
31137,Nebraska,Phelps County,9215,4560,4655,4466,4569,4254,4368,8622,593,No,6.44%,33,0%,454,4.93%
31139,Nebraska,Pierce County,7166,3634,3532,3585,3474,3528,3440,6968,198,No,2.76%,20,0%,108,1.51%
31141,Nebraska,Platte County,32681,16430,16251,15810,15710,13446,13575,27021,5660,No,17.32%,223,1%,5029,15.39%
31143,Nebraska,Polk County,5320,2662,2658,2610,2609,2515,2550,5065,255,No,4.79%,15,0%,175,3.29%
31145,Nebraska,Red Willow County,10975,5445,5530,5245,5388,5041,5154,10195,780,No,7.11%,102,1%,493,4.49%
31147,Nebraska,Richardson County,8290,4108,4182,3857,3950,3806,3910,7716,574,No,6.92%,23,0%,126,1.52%
31149,Nebraska,Rock County,1376,699,677,686,666,679,657,1336,40,No,2.91%,1,0%,16,1.16%
31151,Nebraska,Saline County,14557,7380,7177,6911,6767,5353,5440,10793,3764,No,25.86%,212,1%,3189,21.91%
31153,Nebraska,Sarpy County,165853,82725,83128,74547,74849,68696,69478,138174,27679,No,16.69%,7052,4%,12850,7.75%
31155,Nebraska,Saunders County,20823,10576,10247,10354,10030,10158,9852,20010,813,No,3.90%,81,0%,415,1.99%
31157,Nebraska,Scotts Bluff County,36964,17868,19096,16803,18092,13133,14495,27628,9336,No,25.26%,292,1%,8063,21.81%
31159,Nebraska,Seward County,16935,8662,8273,8438,8072,8277,7944,16221,714,No,4.22%,81,0%,342,2.02%
31161,Nebraska,Sheridan County,5319,2597,2722,2233,2345,2177,2301,4478,841,No,15.81%,13,0%,175,3.29%
31163,Nebraska,Sherman County,3108,1536,1572,1519,1552,1493,1526,3019,89,No,2.86%,5,0%,52,1.67%
31165,Nebraska,Sioux County,1315,669,646,652,630,632,609,1241,74,No,5.63%,1,0%,49,3.73%
31167,Nebraska,Stanton County,6089,3050,3039,2971,2960,2804,2852,5656,433,No,7.11%,55,1%,309,5.07%
31169,Nebraska,Thayer County,5134,2509,2625,2469,2573,2429,2533,4962,172,No,3.35%,16,0%,85,1.66%
31171,Nebraska,Thomas County,676,345,331,341,328,330,317,647,29,No,4.29%,1,0%,22,3.25%
31173,Nebraska,Thurston County,7020,3456,3564,1443,1391,1375,1330,2705,4315,Yes,61.47%,46,1%,328,4.67%
31175,Nebraska,Valley County,4229,2103,2126,2073,2096,2033,2058,4091,138,No,3.26%,7,0%,85,2.01%
31177,Nebraska,Washington County,20252,10109,10143,9859,9924,9636,9733,19369,883,No,4.36%,135,1%,458,2.26%
31179,Nebraska,Wayne County,9554,4793,4761,4597,4595,4390,4369,8759,795,No,8.32%,138,1%,482,5.05%
31181,Nebraska,Webster County,3725,1803,1922,1752,1860,1681,1802,3483,242,No,6.50%,17,0%,139,3.73%
31183,Nebraska,Wheeler County,805,401,404,396,399,394,395,789,16,No,1.99%,0,0%,6,0.75%
31185,Nebraska,York County,13746,6705,7041,6501,6777,6253,6510,12763,983,No,7.15%,181,1%,566,4.12%
32001,Nevada,Churchill County,24375,12271,12104,10596,10302,9263,9076,18339,6036,No,24.76%,503,2%,3131,12.85%
32003,Nevada,Clark County,2000759,1005625,995134,747702,716509,476692,457780,934472,1066287,Yes,53.29%,227061,11%,596269,29.80%
32005,Nevada,Douglas County,46996,23479,23517,21675,21624,19252,19275,38527,8469,No,18.02%,409,1%,5415,11.52%
32007,Nevada,Elko County,51216,26665,24551,23883,21815,18180,16766,34946,16270,No,31.77%,669,1%,12013,23.46%
32009,Nevada,Esmeralda County,775,436,339,402,304,321,246,567,208,No,26.84%,3,0%,142,18.32%
32011,Nevada,Eureka County,2001,1064,937,977,882,847,791,1638,363,No,18.14%,16,1%,252,12.59%
32013,Nevada,Humboldt County,17048,8907,8141,8075,7376,6030,5531,11561,5487,No,32.19%,181,1%,4254,24.95%
32015,Nevada,Lander County,5941,3036,2905,2782,2649,2179,2088,4267,1674,No,28.18%,57,1%,1320,22.22%
32017,Nevada,Lincoln County,5405,2959,2446,2694,2316,2486,2196,4682,723,No,13.38%,158,3%,371,6.86%
32019,Nevada,Lyon County,51327,25884,25443,23489,22900,19962,19552,39514,11813,No,23.02%,694,1%,7897,15.39%
32021,Nevada,Mineral County,4653,2263,2390,1674,1737,1534,1592,3126,1527,No,32.82%,208,4%,457,9.82%
32023,Nevada,Nye County,42963,21762,21201,19688,19062,16969,16471,33440,9523,No,22.17%,1116,3%,6025,14.02%
32027,Nevada,Pershing County,6749,4314,2435,3763,2180,2814,1728,4542,2207,No,32.70%,274,4%,1540,22.82%
32029,Nevada,Storey County,3935,2012,1923,1866,1769,1744,1649,3393,542,No,13.77%,51,1%,263,6.68%
32031,Nevada,Washoe County,429908,216725,213183,186885,182354,141036,138745,279781,150127,No,34.92%,11345,3%,98979,23.02%
32033,Nevada,White Pine County,10042,5711,4331,4923,3897,4090,3449,7539,2503,No,24.93%,427,4%,1401,13.95%
32510,Nevada,Carson City,54838,28094,26744,25040,24257,19120,18925,38045,16793,No,30.62%,1290,2%,12320,22.47%
33001,New Hampshire,Belknap County,60327,29619,30708,28630,29647,28247,29272,57519,2808,No,4.65%,392,1%,882,1.46%
33003,New Hampshire,Carroll County,47567,23636,23931,23020,23328,22796,23071,45867,1700,No,3.57%,206,0%,566,1.19%
33005,New Hampshire,Cheshire County,76851,37440,39411,36060,37968,35551,37472,73023,3828,No,4.98%,520,1%,1192,1.55%
33007,New Hampshire,Coos County,32096,16399,15697,15915,15242,15713,15104,30817,1279,No,3.98%,182,1%,410,1.28%
33009,New Hampshire,Grafton County,89181,44061,45120,41338,42174,40563,41425,81988,7193,No,8.07%,1021,1%,1766,1.98%
33011,New Hampshire,Hillsborough County,402922,199712,203210,182939,187308,173267,177860,351127,51795,No,12.85%,9941,2%,22658,5.62%
33013,New Hampshire,Merrimack County,146761,72376,74385,68921,71031,67770,69907,137677,9084,No,6.19%,1925,1%,2653,1.81%
33015,New Hampshire,Rockingham County,297820,147218,150602,140868,144329,137872,141303,279175,18645,No,6.26%,2474,1%,6894,2.31%
33017,New Hampshire,Strafford County,124119,60491,63628,56582,59959,55625,58943,114568,9551,No,7.70%,1479,1%,2459,1.98%
33019,New Hampshire,Sullivan County,43074,21285,21789,20671,21146,20427,20918,41345,1729,No,4.01%,234,1%,562,1.30%
34001,New Jersey,Atlantic County,275422,133712,141710,96287,100712,76922,81853,158775,116647,No,42.35%,47665,17%,48830,17.73%
34003,New Jersey,Bergen County,918888,443757,475131,336994,357213,270332,287105,557437,361451,No,39.34%,61254,7%,158723,17.27%
34005,New Jersey,Burlington County,451336,222025,229311,166358,172230,154037,161241,315278,136058,No,30.15%,77974,17%,31889,7.07%
34007,New Jersey,Camden County,513539,248152,265387,177473,185371,147738,156754,304492,209047,No,40.71%,107854,21%,77346,15.06%
34009,New Jersey,Cape May County,96304,46901,49403,42948,45554,40150,43085,83235,13069,No,13.57%,4847,5%,6375,6.62%
34011,New Jersey,Cumberland County,157785,81600,76185,57491,56876,37954,39572,77526,80259,Yes,50.87%,34429,22%,44304,28.08%
34013,New Jersey,Essex County,787744,378850,408894,195480,198194,127223,133285,260508,527236,Yes,66.93%,331805,42%,167733,21.29%
34015,New Jersey,Gloucester County,289586,140508,149078,119321,125368,113226,119571,232797,56789,No,19.61%,30454,11%,14990,5.18%
34017,New Jersey,Hudson County,652302,324230,328072,216571,216602,99940,96959,196899,455403,Yes,69.81%,97873,15%,278120,42.64%
34019,New Jersey,Hunterdon County,127050,63220,63830,58070,59050,54763,55947,110710,16340,No,12.86%,3662,3%,7248,5.70%
34021,New Jersey,Mercer County,368303,180189,188114,121102,123884,94787,101664,196451,171852,No,46.66%,77436,21%,58567,15.90%
34023,New Jersey,Middlesex County,823041,404809,418232,257343,265903,190911,199904,390815,432226,Yes,52.52%,89346,11%,157231,19.10%
34025,New Jersey,Monmouth County,629384,306378,323006,261544,273877,233256,247476,480732,148652,No,23.62%,48251,8%,63200,10.04%
34027,New Jersey,Morris County,497999,244012,253987,207671,215265,179811,188238,368049,129950,No,26.09%,17112,3%,60177,12.08%
34029,New Jersey,Ocean County,580470,278654,301816,259558,281071,236609,259301,495910,84560,No,14.57%,19880,3%,50384,8.68%
34031,New Jersey,Passaic County,502885,244614,258271,187449,194214,108490,114197,222687,280198,Yes,55.72%,73733,15%,192553,38.29%
34033,New Jersey,Salem County,65774,32123,33651,26399,27401,24393,25597,49990,15784,No,24.00%,9691,15%,4859,7.39%
34035,New Jersey,Somerset County,327707,159918,167789,116652,121681,96655,102584,199239,128468,No,39.20%,31512,10%,44380,13.54%
34037,New Jersey,Sussex County,147442,73235,74207,69159,70052,64674,65410,130084,17358,No,11.77%,2988,2%,10036,6.81%
34039,New Jersey,Union County,543976,264389,279587,185708,189777,116298,122822,239120,304856,Yes,56.04%,126735,23%,156154,28.71%
34041,New Jersey,Warren County,107653,52409,55244,47944,50613,44229,46923,91152,16501,No,15.33%,4378,4%,8299,7.71%
35001,New Mexico,Bernalillo County,673460,330567,342893,281780,292383,135649,140101,275750,397710,Yes,59.05%,23020,3%,326098,48.42%
35003,New Mexico,Catron County,3658,1888,1770,1772,1653,1405,1365,2770,888,No,24.28%,19,1%,711,19.44%
35005,New Mexico,Chaves County,65784,32724,33060,30207,30684,13747,14309,28056,37728,Yes,57.35%,1722,3%,35031,53.25%
35006,New Mexico,Cibola County,27334,13901,13433,7975,6928,2948,2897,5845,21489,Yes,78.62%,354,1%,10207,37.34%
35007,New Mexico,Colfax County,13223,6751,6472,6318,6155,3224,3200,6424,6799,Yes,51.42%,90,1%,6377,48.23%
35009,New Mexico,Curry County,49938,25409,24529,22009,21255,12897,12453,25350,24588,No,49.24%,3411,7%,19839,39.73%
35015,New Mexico,Eddy County,54419,27219,27200,25390,25492,13873,14025,27898,26521,No,48.73%,954,2%,24523,45.06%
35017,New Mexico,Grant County,29388,14526,14862,13655,14016,6979,7085,14064,15324,Yes,52.14%,336,1%,14402,49.01%
35019,New Mexico,Guadalupe County,4603,2625,1978,2387,1862,449,277,726,3877,Yes,84.23%,94,2%,3674,79.82%
35021,New Mexico,Harding County,707,368,339,354,323,203,191,394,313,No,44.27%,7,1%,297,42.01%
35023,New Mexico,Hidalgo County,4794,2420,2374,2327,2274,1004,999,2003,2791,Yes,58.22%,56,1%,2679,55.88%
35025,New Mexico,Lea County,66338,34068,32270,31106,29801,13580,13607,27187,39151,Yes,59.02%,2906,4%,35344,53.28%
35027,New Mexico,Lincoln County,20309,9976,10333,9399,9693,6438,6739,13177,7132,No,35.12%,169,1%,6295,31.00%
35028,New Mexico,Los Alamos County,18159,9140,9019,8217,8063,6962,6659,13621,4538,No,24.99%,134,1%,2838,15.63%
35029,New Mexico,Luna County,25041,12484,12557,11767,11802,4328,4210,8538,16503,Yes,65.90%,380,2%,15817,63.16%
35031,New Mexico,McKinley County,73016,35258,37758,7002,7003,3720,3741,7461,65555,Yes,89.78%,655,1%,10060,13.78%
35033,New Mexico,Mora County,4705,2411,2294,2271,2163,400,450,850,3855,Yes,81.93%,46,1%,3790,80.55%
35035,New Mexico,Otero County,66041,33571,32470,28446,27286,17974,16477,34451,31590,No,47.83%,2585,4%,23288,35.26%
35037,New Mexico,Quay County,8769,4298,4471,3987,4175,2248,2349,4597,4172,No,47.58%,140,2%,3801,43.35%
35039,New Mexico,Rio Arriba County,40318,19866,20452,15716,15944,2615,2733,5348,34970,Yes,86.74%,330,1%,28752,71.31%
35041,New Mexico,Roosevelt County,20419,10324,10095,9530,9390,5538,5637,11175,9244,No,45.27%,443,2%,8242,40.36%
35043,New Mexico,Sandoval County,135588,66372,69216,52999,54929,30996,32127,63123,72465,Yes,53.44%,3348,2%,49211,36.29%
35045,New Mexico,San Juan County,128529,63767,64762,36937,37146,26246,26759,53005,75524,Yes,58.76%,999,1%,24785,19.28%
35047,New Mexico,San Miguel County,28891,14338,14553,13241,13440,2758,2913,5671,23220,Yes,80.37%,505,2%,22209,76.87%
35049,New Mexico,Santa Fe County,146375,71363,75012,65079,68736,30152,33880,64032,82343,Yes,56.25%,1602,1%,74527,50.92%
35051,New Mexico,Sierra County,11895,5943,5952,5574,5577,3985,4007,7992,3903,No,32.81%,85,1%,3437,28.89%
35053,New Mexico,Socorro County,17603,8983,8620,7454,7143,3458,3075,6533,11070,Yes,62.89%,207,1%,8610,48.91%
35055,New Mexico,Taos County,32779,16110,16669,14212,14771,5613,6213,11826,20953,Yes,63.92%,252,1%,18437,56.25%
35057,New Mexico,Torrance County,16021,8326,7695,7564,7030,4540,4286,8826,7195,No,44.91%,322,2%,6373,39.78%
35059,New Mexico,Union County,4431,2538,1893,2328,1793,1275,1146,2421,2010,No,45.36%,80,2%,1818,41.03%
35061,New Mexico,Valencia County,76631,38684,37947,34776,34290,13555,13604,27159,49472,Yes,64.56%,1273,2%,45089,58.84%
36001,New York,Albany County,305455,147620,157835,116415,123780,111118,118358,229476,75979,No,24.87%,40868,13%,16290,5.33%
36003,New York,Allegany County,48357,24415,23942,23453,23078,23166,22820,45986,2371,No,4.90%,619,1%,712,1.47%
36005,New York,Bronx County,1408473,663210,745263,308672,335888,73879,77532,151411,1257062,Yes,89.25%,610976,43%,764608,54.29%
36007,New York,Broome County,198060,97061,100999,85518,89749,82936,87314,170250,27810,No,14.04%,10319,5%,7058,3.56%
36009,New York,Cattaraugus County,79458,39285,40173,36500,37283,35927,36735,72662,6796,No,8.55%,1129,1%,1519,1.91%
36011,New York,Cayuga County,79552,40633,38919,36861,37053,35970,36520,72490,7062,No,8.88%,3423,4%,1986,2.50%
36013,New York,Chautauqua County,133539,66079,67460,61928,63926,58146,60458,118604,14935,No,11.18%,3545,3%,8667,6.49%
36015,New York,Chemung County,88911,44265,44646,38420,40674,37412,39933,77345,11566,No,13.01%,5985,7%,2491,2.80%
36017,New York,Chenango County,49933,24879,25054,24082,24368,23617,23945,47562,2371,No,4.75%,416,1%,997,2.00%
36019,New York,Clinton County,81654,41915,39739,37905,37853,36937,37262,74199,7455,No,9.13%,3445,4%,2101,2.57%
36021,New York,Columbia County,62499,31361,31138,28375,28536,27274,27593,54867,7632,No,12.21%,3031,5%,2565,4.10%
36023,New York,Cortland County,49474,24169,25305,22977,24115,22472,23629,46101,3373,No,6.82%,902,2%,1217,2.46%
36025,New York,Delaware County,47276,23686,23590,22640,22602,22009,21931,43940,3336,No,7.06%,865,2%,1566,3.31%
36027,New York,Dutchess County,297322,147955,149367,121520,124495,107748,111816,219564,77758,No,26.15%,31864,11%,32629,10.97%
36029,New York,Erie County,919086,444184,474902,360809,382715,344052,365806,709858,209228,No,22.76%,127232,14%,44253,4.81%
36031,New York,Essex County,38961,20206,18755,18687,18260,18116,18068,36184,2777,No,7.13%,1096,3%,1013,2.60%
36033,New York,Franklin County,51795,28522,23273,22875,20703,22019,20429,42448,9347,No,18.05%,3411,7%,1665,3.21%
36035,New York,Fulton County,54925,27180,27745,25867,26718,25242,26166,51408,3517,No,6.40%,1081,2%,1399,2.55%
36037,New York,Genesee County,59977,29808,30169,27681,28321,26918,27783,54701,5276,No,8.80%,1829,3%,1678,2.80%
36039,New York,Greene County,48673,25412,23261,22296,21954,21075,21129,42204,6469,No,13.29%,2981,6%,2484,5.10%
36041,New York,Hamilton County,4778,2406,2372,2333,2310,2309,2287,4596,182,No,3.81%,42,1%,55,1.15%
36043,New York,Herkimer County,64508,31661,32847,30665,31842,30190,31400,61590,2918,No,4.52%,783,1%,1152,1.79%
36045,New York,Jefferson County,120262,62228,58034,54563,52190,50858,49512,100370,19892,No,16.54%,7309,6%,8049,6.69%
36047,New York,Kings County,2565635,1214885,1350750,624045,644675,449524,469121,918645,1646990,Yes,64.19%,919242,36%,507552,19.78%
36049,New York,Lewis County,27224,13773,13451,13425,13138,13221,13017,26238,986,No,3.62%,228,1%,396,1.45%
36051,New York,Livingston County,64810,32528,32282,30212,30845,29257,30200,59457,5353,No,8.26%,1778,3%,1968,3.04%
36053,New York,Madison County,72382,35458,36924,33775,35165,33206,34661,67867,4515,No,6.24%,1343,2%,1380,1.91%
36055,New York,Monroe County,747813,361171,386642,283157,299260,262824,278330,541154,206659,No,27.64%,119458,16%,57150,7.64%
36057,New York,Montgomery County,49941,24486,25455,23070,24124,20449,21616,42065,7876,No,15.77%,1241,2%,6002,12.02%
36059,New York,Nassau County,1349233,653809,695424,508627,533820,418794,446216,865010,484223,No,35.89%,164379,12%,207002,15.34%
36061,New York,New York County,1619090,763920,855170,506650,548188,370030,400733,770763,848327,Yes,52.40%,298158,18%,417471,25.78%
36063,New York,Niagara County,215124,104566,110558,92904,98065,90886,96174,187060,28064,No,13.05%,15010,7%,5042,2.34%
36065,New York,Oneida County,233556,116276,117280,101180,104291,96427,100350,196777,36779,No,15.75%,15418,7%,11473,4.91%
36067,New York,Onondaga County,466852,225354,241498,184285,196998,177524,190144,367668,99184,No,21.25%,53523,11%,20138,4.31%
36069,New York,Ontario County,108519,53136,55383,50088,52369,48245,50850,99095,9424,No,8.68%,2688,2%,4156,3.83%
36071,New York,Orange County,374512,187419,187093,154556,154457,125746,126142,251888,122624,No,32.74%,42604,11%,70282,18.77%
36073,New York,Orleans County,42836,21278,21558,19027,19606,18262,18919,37181,5655,No,13.20%,2876,7%,1867,4.36%
36075,New York,Oswego County,121700,60740,60960,58739,58860,57610,57778,115388,6312,No,5.19%,1164,1%,2687,2.21%
36077,New York,Otsego County,61709,29929,31780,28365,30193,27565,29394,56959,4750,No,7.70%,1251,2%,2020,3.27%
36079,New York,Putnam County,99607,49555,50052,46222,46607,40579,41402,81981,17626,No,17.70%,2788,3%,12115,12.16%
36081,New York,Queens County,2272771,1102593,1170178,563774,573656,301079,316446,617525,1655246,Yes,72.83%,475464,21%,634077,27.90%
36083,New York,Rensselaer County,159835,78959,80876,69478,71325,67079,69038,136117,23718,No,14.84%,11137,7%,6627,4.15%
36085,New York,Richmond County,470728,227763,242965,178370,188222,144933,154351,299284,171444,No,36.42%,54741,12%,83181,17.67%
36087,New York,Rockland County,317757,155849,161908,122592,125589,100125,104562,204687,113070,No,35.58%,40721,13%,51899,16.33%
36089,New York,St. Lawrence County,112232,57143,55089,52949,52570,51866,51899,103765,8467,No,7.54%,2813,3%,2341,2.09%
36091,New York,Saratoga County,222133,109378,112755,103045,106634,100436,104157,204593,17540,No,7.90%,3746,2%,5996,2.70%
36093,New York,Schenectady County,155124,75189,79935,60559,64907,57388,61827,119215,35909,No,23.15%,16813,11%,9473,6.11%
36095,New York,Schoharie County,32099,16006,16093,15402,15524,15004,15125,30129,1970,No,6.14%,419,1%,944,2.94%
36097,New York,Schuyler County,18514,9277,9237,8966,8969,8814,8879,17693,821,No,4.43%,211,1%,307,1.66%
36099,New York,Seneca County,35305,18457,16848,16415,16207,15845,15910,31755,3550,No,10.06%,1794,5%,1077,3.05%
36101,New York,Steuben County,99063,49122,49941,46676,47786,46015,47245,93260,5803,No,5.86%,1578,2%,1470,1.48%
36103,New York,Suffolk County,1499273,738012,761261,634483,651661,516824,541985,1058809,440464,No,29.38%,122296,8%,259534,17.31%
36105,New York,Sullivan County,76793,39375,37418,33242,32396,28563,28261,56824,19969,No,26.00%,7490,10%,10886,14.18%
36107,New York,Tioga County,50478,25038,25440,24272,24707,23930,24429,48359,2119,No,4.20%,436,1%,748,1.48%
36109,New York,Tompkins County,102554,50627,51927,41500,43170,39736,41426,81162,21392,No,20.86%,4446,4%,4676,4.56%
36111,New York,Ulster County,181791,90399,91392,79099,82041,71767,75563,147330,34461,No,18.96%,12086,7%,16857,9.27%
36113,New York,Warren County,65538,32049,33489,30882,32353,30364,31799,62163,3375,No,5.15%,707,1%,1277,1.95%
36115,New York,Washington County,62934,32546,30388,30140,29619,29403,29216,58619,4315,No,6.86%,2032,3%,1489,2.37%
36117,New York,Wayne County,92962,46117,46845,43142,44222,41470,42862,84332,8630,No,9.28%,2983,3%,3614,3.89%
36119,New York,Westchester County,961670,463701,497969,352511,370030,260665,280821,541486,420184,No,43.69%,151888,16%,219719,22.85%
36121,New York,Wyoming County,41892,22869,19023,19959,18646,19259,18452,37711,4181,No,9.98%,2568,6%,1246,2.97%
36123,New York,Yates County,25344,12325,13019,12010,12676,11758,12497,24255,1089,No,4.30%,245,1%,488,1.93%
37001,North Carolina,Alamance County,153920,73236,80684,56103,60993,48570,53936,102506,51414,No,33.40%,29607,19%,17815,11.57%
37003,North Carolina,Alexander County,36853,18656,18197,16900,16863,16153,16174,32327,4526,No,12.28%,2088,6%,1588,4.31%
37005,North Carolina,Alleghany County,10927,5440,5487,5199,5311,4625,4963,9588,1339,No,12.25%,174,2%,1023,9.36%
37007,North Carolina,Anson County,26351,13727,12624,6586,6103,6121,5918,12039,14312,Yes,54.31%,12809,49%,837,3.18%
37009,North Carolina,Ashe County,27097,13342,13755,12988,13404,12217,13010,25227,1870,No,6.90%,234,1%,1290,4.76%
37011,North Carolina,Avery County,17635,9630,8005,8783,7783,8261,7530,15791,1844,No,10.46%,753,4%,826,4.68%
37013,North Carolina,Beaufort County,47507,22892,24615,16690,17364,15223,16147,31370,16137,No,33.97%,12176,26%,3428,7.22%
37015,North Carolina,Bertie County,20653,10317,10336,3705,3711,3603,3637,7240,13413,Yes,64.94%,12781,62%,310,1.50%
37017,North Carolina,Bladen County,34915,16770,18145,10438,10702,9258,9796,19054,15861,No,45.43%,12231,35%,2559,7.33%
37019,North Carolina,Brunswick County,112257,54877,57380,46900,48872,44194,46777,90971,21286,No,18.96%,12889,11%,5582,4.97%
37021,North Carolina,Buncombe County,244490,117673,126817,105521,113943,98239,107458,205697,38793,No,15.87%,16011,7%,15317,6.26%
37023,North Carolina,Burke County,90505,45142,45363,38523,39913,36350,38211,74561,15944,No,17.62%,6163,7%,5148,5.69%
37025,North Carolina,Cabarrus County,184498,90108,94390,71671,73745,63783,66357,130140,54358,No,29.46%,29872,16%,17976,9.74%
37027,North Carolina,Caldwell County,81930,40484,41446,37306,38271,35575,36783,72358,9572,No,11.68%,4209,5%,3892,4.75%
37029,North Carolina,Camden County,10090,5051,5039,4171,4146,4074,4061,8135,1955,No,19.38%,1321,13%,238,2.36%
37031,North Carolina,Carteret County,67632,33375,34257,29928,30888,28740,29941,58681,8951,No,13.23%,4285,6%,2554,3.78%
37033,North Carolina,Caswell County,23217,11805,11412,7562,7284,7192,7025,14217,9000,No,38.76%,7841,34%,747,3.22%
37035,North Carolina,Catawba County,154339,75676,78663,64471,67219,58234,61689,119923,34416,No,22.30%,13443,9%,13084,8.48%
37037,North Carolina,Chatham County,65976,31721,34255,26269,28031,22415,24643,47058,18918,No,28.67%,8930,14%,8517,12.91%
37039,North Carolina,Cherokee County,26992,13135,13857,12328,13078,12033,12805,24838,2154,No,7.98%,376,1%,734,2.72%
37041,North Carolina,Chowan County,14772,7034,7738,4576,4778,4348,4611,8959,5813,No,39.35%,5072,34%,514,3.48%
37043,North Carolina,Clay County,10618,5228,5390,5063,5242,4911,5126,10037,581,No,5.47%,104,1%,293,2.76%
37045,North Carolina,Cleveland County,97474,46965,50509,36319,38400,35006,37230,72236,25238,No,25.89%,20205,21%,2947,3.02%
37047,North Carolina,Columbus County,57638,28503,29135,18090,18788,16963,17881,34844,22794,No,39.55%,17642,31%,2679,4.65%
37049,North Carolina,Craven County,104770,52712,52058,38704,37133,35417,34688,70105,34665,No,33.09%,23164,22%,6965,6.65%
37051,North Carolina,Cumberland County,324049,157911,166138,87734,86432,75534,75040,150574,173475,Yes,53.53%,121332,37%,32972,10.18%
37053,North Carolina,Currituck County,24077,11926,12151,10903,10993,10564,10656,21220,2857,No,11.87%,1434,6%,817,3.39%
37055,North Carolina,Dare County,34573,17186,17387,16216,16412,15048,15462,30510,4063,No,11.75%,977,3%,2338,6.76%
37057,North Carolina,Davidson County,163260,80000,83260,70251,72463,65442,68187,133629,29631,No,18.15%,14854,9%,10481,6.42%
37059,North Carolina,Davie County,41433,20155,21278,18311,19222,17146,18169,35315,6118,No,14.77%,2693,6%,2558,6.17%
37061,North Carolina,Duplin County,60033,29546,30487,21286,21050,15332,16124,31456,28577,No,47.60%,15594,26%,12728,21.20%
37063,North Carolina,Durham County,279641,133184,146457,72646,75595,55993,61766,117759,161882,Yes,57.89%,108441,39%,37512,13.41%
37065,North Carolina,Edgecombe County,55954,25870,30084,10811,11798,9927,11056,20983,34971,Yes,62.50%,32251,58%,2173,3.88%
37067,North Carolina,Forsyth County,358137,169978,188159,117304,126069,99377,109408,208785,149352,No,41.70%,96953,27%,44267,12.36%
37069,North Carolina,Franklin County,61475,30549,30926,21599,21301,19564,19611,39175,22300,No,36.27%,16623,27%,4736,7.70%
37071,North Carolina,Gaston County,208049,100502,107547,81812,86217,75926,80870,156796,51253,No,24.64%,32671,16%,12795,6.15%
37073,North Carolina,Gates County,11869,5847,6022,3795,3786,3711,3727,7438,4431,No,37.33%,3967,33%,198,1.67%
37075,North Carolina,Graham County,8700,4286,4414,3885,3998,3786,3930,7716,984,No,11.31%,25,0%,232,2.67%
37077,North Carolina,Granville County,60436,32201,28235,20296,18353,18006,16813,34819,25617,No,42.39%,19955,33%,4698,7.77%
37079,North Carolina,Greene County,21429,11623,9806,6777,5864,5328,4851,10179,11250,Yes,52.50%,7953,37%,3091,14.42%
37081,North Carolina,Guilford County,500879,238728,262151,144096,152848,128215,139025,267240,233639,No,46.65%,167959,34%,37085,7.40%
37083,North Carolina,Halifax County,54006,25839,28167,10748,11361,10303,10966,21269,32737,Yes,60.62%,28716,53%,1331,2.46%
37085,North Carolina,Harnett County,122135,60083,62052,43803,44744,37926,39585,77511,44624,No,36.54%,26257,21%,13809,11.31%
37087,North Carolina,Haywood County,58908,28524,30384,27577,29407,26600,28518,55118,3790,No,6.43%,716,1%,2048,3.48%
37089,North Carolina,Henderson County,108266,52383,55883,48843,52126,43318,47667,90985,17281,No,15.96%,3513,3%,10786,9.96%
37091,North Carolina,Hertford County,24438,11977,12461,4572,4258,4207,4116,8323,16115,Yes,65.94%,14809,61%,749,3.06%
37093,North Carolina,Hoke County,50536,24817,25719,12842,12628,10400,10353,20753,29783,Yes,58.93%,17301,34%,6246,12.36%
37095,North Carolina,Hyde County,5859,3258,2601,2049,1846,1858,1644,3502,2357,No,40.23%,1836,31%,429,7.32%
37097,North Carolina,Iredell County,162708,80110,82598,67153,68370,62062,63583,125645,37063,No,22.78%,19949,12%,11368,6.99%
37099,North Carolina,Jackson County,40448,19966,20482,17104,17527,16190,16861,33051,7397,No,18.29%,823,2%,2015,4.98%
37101,North Carolina,Johnston County,174938,86019,88919,69930,71533,59085,62372,121457,53481,No,30.57%,27519,16%,22948,13.12%
37103,North Carolina,Jones County,10275,4935,5340,3275,3424,3082,3257,6339,3936,No,38.31%,3280,32%,429,4.18%
37105,North Carolina,Lee County,59715,29415,30300,22395,22654,16919,17877,34796,24919,No,41.73%,12127,20%,11610,19.44%
37107,North Carolina,Lenoir County,59227,28289,30938,16443,17049,14540,15593,30133,29094,No,49.12%,24233,41%,4036,6.81%
37109,North Carolina,Lincoln County,79313,39444,39869,36249,36606,33540,34204,67744,11569,No,14.59%,4649,6%,5513,6.95%
37111,North Carolina,McDowell County,44998,22498,22500,20805,21092,19671,20168,39839,5159,No,11.46%,1808,4%,2488,5.53%
37113,North Carolina,Macon County,33869,16422,17447,15658,16840,14595,15862,30457,3412,No,10.07%,563,2%,2235,6.60%
37115,North Carolina,Madison County,20742,10261,10481,9864,10148,9637,9960,19597,1145,No,5.52%,289,1%,459,2.21%
37117,North Carolina,Martin County,23961,11224,12737,6303,6741,5926,6484,12410,11551,No,48.21%,10467,44%,816,3.41%
37119,North Carolina,Mecklenburg County,969031,467859,501172,288201,294349,235627,246550,482177,486854,Yes,50.24%,307802,32%,121495,12.54%
37121,North Carolina,Mitchell County,15368,7545,7823,7305,7598,6989,7374,14363,1005,No,6.54%,83,1%,689,4.48%
37123,North Carolina,Montgomery County,27668,13385,14283,10478,10913,8541,9176,17717,9951,No,35.97%,5270,19%,4044,14.62%
37125,North Carolina,Moore County,90302,43233,47069,36172,38601,33637,36342,69979,20323,No,22.51%,12127,13%,5477,6.07%
37127,North Carolina,Nash County,95708,46303,49405,27349,28119,24692,25872,50564,45144,No,47.17%,36796,38%,6177,6.45%
37129,North Carolina,New Hanover County,209234,101023,108211,82767,87567,77747,83226,160973,48261,No,23.07%,30593,15%,11260,5.38%
37131,North Carolina,Northampton County,21428,10386,11042,4290,4257,4146,4175,8321,13107,Yes,61.17%,12492,58%,363,1.69%
37133,North Carolina,Onslow County,183263,98871,84392,76679,63706,67215,56715,123930,59333,No,32.38%,29764,16%,20422,11.14%
37135,North Carolina,Orange County,137941,65858,72083,51318,55399,46144,50848,96992,40949,No,29.69%,16780,12%,11368,8.24%
37137,North Carolina,Pamlico County,13074,6686,6388,5093,5006,4883,4856,9739,3335,No,25.51%,2655,20%,430,3.29%
37139,North Carolina,Pasquotank County,40591,19905,20686,11728,11865,11031,11201,22232,18359,No,45.23%,15423,38%,1767,4.35%
37141,North Carolina,Pender County,54195,27073,27122,21527,21303,19935,20105,40040,14155,No,26.12%,9605,18%,3350,6.18%
37143,North Carolina,Perquimans County,13563,6526,7037,4819,5068,4711,4960,9671,3892,No,28.70%,3375,25%,288,2.12%
37145,North Carolina,Person County,39268,19101,20167,13591,14028,12770,13434,26204,13064,No,33.27%,10638,27%,1640,4.18%
37147,North Carolina,Pitt County,172554,81418,91136,50936,54627,46852,50995,97847,74707,No,43.29%,59765,35%,9883,5.73%
37149,North Carolina,Polk County,20271,9722,10549,9056,9835,8492,9378,17870,2401,No,11.84%,912,4%,1161,5.73%
37151,North Carolina,Randolph County,142466,70330,72136,63508,65162,56457,58839,115296,27170,No,19.07%,8673,6%,15199,10.67%
37153,North Carolina,Richmond County,46627,22936,23691,14469,14809,13199,13864,27063,19564,No,41.96%,14523,31%,2936,6.30%
37155,North Carolina,Robeson County,135496,65835,69661,22046,22368,17667,18892,36559,98937,Yes,73.02%,33527,25%,11057,8.16%
37157,North Carolina,Rockingham County,92720,44733,47987,35260,37297,32662,35194,67856,24864,No,26.82%,17609,19%,5293,5.71%
37159,North Carolina,Rowan County,138180,68159,70021,55003,56213,49945,51715,101660,36520,No,26.43%,22669,16%,10885,7.88%
37161,North Carolina,Rutherford County,67323,32507,34816,28445,30430,27270,29363,56633,10690,No,15.88%,6752,10%,2548,3.78%
37163,North Carolina,Sampson County,63949,31467,32482,21428,21531,16354,17352,33706,30243,No,47.29%,17443,27%,11193,17.50%
37165,North Carolina,Scotland County,36094,17676,18418,8224,8664,7905,8422,16327,19767,Yes,54.77%,14026,39%,901,2.50%
37167,North Carolina,Stanly County,60576,30215,30361,25630,25949,24562,25127,49689,10887,No,17.97%,6760,11%,2270,3.75%
37169,North Carolina,Stokes County,46783,22814,23969,21400,22552,20806,22030,42836,3947,No,8.44%,1974,4%,1258,2.69%
37171,North Carolina,Surry County,73561,35881,37680,33574,35317,30026,32250,62276,11285,No,15.34%,2969,4%,7358,10.00%
37173,North Carolina,Swain County,14141,6874,7267,4584,4812,4417,4685,9102,5039,No,35.63%,143,1%,617,4.36%
37175,North Carolina,Transylvania County,32849,15827,17022,14755,15977,14229,15575,29804,3045,No,9.27%,1310,4%,1003,3.05%
37177,North Carolina,Tyrrell County,4338,2397,1941,1288,1237,1189,1097,2286,2052,No,47.30%,1632,38%,319,7.35%
37179,North Carolina,Union County,208520,102906,105614,86413,88106,75845,78502,154347,54173,No,25.98%,25171,12%,22580,10.83%
37181,North Carolina,Vance County,45132,21119,24013,10136,10974,8877,9836,18713,26419,Yes,58.54%,22852,51%,3180,7.05%
37183,North Carolina,Wake County,952151,463765,488386,327957,334950,287724,298475,586199,365952,No,38.43%,203809,21%,95011,9.98%
37185,North Carolina,Warren County,20576,10477,10099,4318,3993,4019,3802,7821,12755,Yes,61.99%,10742,52%,750,3.65%
37187,North Carolina,Washington County,12736,5997,6739,2929,3166,2751,3020,5771,6965,Yes,54.69%,6333,50%,498,3.91%
37189,North Carolina,Watauga County,51871,25963,25908,24739,24744,23877,24027,47904,3967,No,7.65%,923,2%,1780,3.43%
37191,North Carolina,Wayne County,124246,61080,63166,39895,39389,34058,34394,68452,55794,No,44.91%,39823,32%,12878,10.36%
37193,North Carolina,Wilkes County,69306,34191,35115,31886,32992,29970,31353,61323,7983,No,11.52%,3027,4%,3954,5.71%
37195,North Carolina,Wilson County,81867,38969,42898,22971,24116,19208,20985,40193,41674,Yes,50.90%,32435,40%,7995,9.77%
37197,North Carolina,Yadkin County,38084,18777,19307,17762,18271,15886,16595,32481,5603,No,14.71%,1294,3%,3902,10.25%
37199,North Carolina,Yancey County,17630,8654,8976,8362,8716,8009,8425,16434,1196,No,6.78%,183,1%,815,4.62%
38001,North Dakota,Adams County,2311,1121,1190,1085,1154,1070,1147,2217,94,No,4.07%,8,0%,24,1.04%
38003,North Dakota,Barnes County,11015,5488,5527,5242,5336,5174,5274,10448,567,No,5.15%,104,1%,162,1.47%
38005,North Dakota,Benson County,6760,3465,3295,1549,1381,1527,1364,2891,3869,Yes,57.23%,7,0%,77,1.14%
38007,North Dakota,Billings County,905,490,415,475,409,473,404,877,28,No,3.09%,2,0%,9,0.99%
38009,North Dakota,Bottineau County,6579,3441,3138,3235,2994,3199,2952,6151,428,No,6.51%,40,1%,99,1.50%
38011,North Dakota,Bowman County,3202,1632,1570,1594,1533,1535,1498,3033,169,No,5.28%,5,0%,118,3.69%
38013,North Dakota,Burke County,2171,1161,1010,1134,980,1110,961,2071,100,No,4.61%,8,0%,47,2.16%
38015,North Dakota,Burleigh County,85774,42275,43499,39181,40514,38684,40000,78684,7090,No,8.27%,703,1%,1308,1.52%
38017,North Dakota,Cass County,156157,78856,77301,72090,70994,70536,69623,140159,15998,No,10.24%,4393,3%,3559,2.28%
38019,North Dakota,Cavalier County,3948,2005,1943,1946,1894,1932,1878,3810,138,No,3.50%,14,0%,40,1.01%
38021,North Dakota,Dickey County,5268,2605,2663,2512,2574,2452,2531,4983,285,No,5.41%,51,1%,128,2.43%
38023,North Dakota,Divide County,2228,1153,1075,1120,1045,1100,1023,2123,105,No,4.71%,13,1%,48,2.15%
38025,North Dakota,Dunn County,3967,2099,1868,1833,1610,1793,1583,3376,591,No,14.90%,19,0%,81,2.04%
38027,North Dakota,Eddy County,2368,1154,1214,1089,1165,1047,1147,2194,174,No,7.35%,4,0%,66,2.79%
38029,North Dakota,Emmons County,3491,1800,1691,1771,1662,1754,1646,3400,91,No,2.61%,7,0%,34,0.97%
38031,North Dakota,Foster County,3392,1686,1706,1654,1670,1634,1651,3285,107,No,3.15%,10,0%,45,1.33%
38033,North Dakota,Golden Valley County,1804,900,904,880,878,865,858,1723,81,No,4.49%,15,1%,39,2.16%
38035,North Dakota,Grand Forks County,67472,34686,32786,31284,29755,30275,28891,59166,8306,No,12.31%,1659,2%,2285,3.39%
38037,North Dakota,Grant County,2333,1173,1160,1142,1127,1136,1122,2258,75,No,3.21%,1,0%,12,0.51%
38039,North Dakota,Griggs County,2362,1205,1157,1190,1140,1185,1138,2323,39,No,1.65%,8,0%,10,0.42%
38041,North Dakota,Hettinger County,2553,1232,1321,1189,1230,1178,1218,2396,157,No,6.15%,12,0%,29,1.14%
38043,North Dakota,Kidder County,2426,1239,1187,1211,1151,1172,1114,2286,140,No,5.77%,7,0%,94,3.87%
38045,North Dakota,LaMoure County,4114,2116,1998,2082,1973,2071,1954,4025,89,No,2.16%,11,0%,32,0.78%
38047,North Dakota,Logan County,1924,983,941,969,926,964,916,1880,44,No,2.29%,2,0%,17,0.88%
38049,North Dakota,McHenry County,5789,3024,2765,2967,2684,2913,2634,5547,242,No,4.18%,15,0%,119,2.06%
38051,North Dakota,McIntosh County,2751,1346,1405,1325,1368,1302,1348,2650,101,No,3.67%,9,0%,43,1.56%
38053,North Dakota,McKenzie County,7987,4174,3813,3397,2927,3296,2850,6146,1841,No,23.05%,31,0%,283,3.54%
38055,North Dakota,McLean County,9309,4770,4539,4368,4131,4318,4094,8412,897,No,9.64%,18,0%,153,1.64%
38057,North Dakota,Mercer County,8486,4388,4098,4201,3922,4157,3870,8027,459,No,5.41%,31,0%,134,1.58%
38059,North Dakota,Morton County,28101,14096,14005,13176,13097,12999,12947,25946,2155,No,7.67%,179,1%,456,1.62%
38061,North Dakota,Mountrail County,8734,4797,3937,3359,2506,3227,2414,5641,3093,No,35.41%,49,1%,381,4.36%
38063,North Dakota,Nelson County,3080,1567,1513,1527,1453,1504,1441,2945,135,No,4.38%,13,0%,41,1.33%
38065,North Dakota,Oliver County,1838,979,859,939,833,927,821,1748,90,No,4.90%,7,0%,30,1.63%
38067,North Dakota,Pembina County,7271,3719,3552,3564,3405,3465,3323,6788,483,No,6.64%,38,1%,188,2.59%
38069,North Dakota,Pierce County,4457,2239,2218,2087,2112,2051,2081,4132,325,No,7.29%,24,1%,83,1.86%
38071,North Dakota,Ramsey County,11536,5755,5781,5086,5036,5024,4983,10007,1529,No,13.25%,50,0%,187,1.62%
38073,North Dakota,Ransom County,5444,2765,2679,2708,2607,2669,2575,5244,200,No,3.67%,20,0%,75,1.38%
38075,North Dakota,Renville County,2559,1328,1231,1295,1207,1274,1193,2467,92,No,3.60%,9,0%,36,1.41%
38077,North Dakota,Richland County,16217,8400,7817,8014,7401,7870,7284,15154,1063,No,6.55%,117,1%,346,2.13%
38079,North Dakota,Rolette County,14382,7094,7288,1524,1494,1484,1460,2944,11438,Yes,79.53%,43,0%,209,1.45%
38081,North Dakota,Sargent County,3896,2058,1838,1994,1789,1941,1753,3694,202,No,5.18%,13,0%,99,2.54%
38083,North Dakota,Sheridan County,1266,648,618,634,596,628,590,1218,48,No,3.79%,3,0%,14,1.11%
38085,North Dakota,Sioux County,4347,2164,2183,316,277,308,275,583,3764,Yes,86.59%,12,0%,97,2.23%
38087,North Dakota,Slope County,758,413,345,396,338,390,335,725,33,No,4.35%,1,0%,17,2.24%
38089,North Dakota,Stark County,26771,13691,13080,13011,12446,12619,12098,24717,2054,No,7.67%,278,1%,843,3.15%
38091,North Dakota,Steele County,1989,1016,973,995,950,984,937,1921,68,No,3.42%,5,0%,25,1.26%
38093,North Dakota,Stutsman County,20934,10674,10260,10128,9879,9963,9761,19724,1210,No,5.78%,217,1%,367,1.75%
38095,North Dakota,Towner County,2318,1198,1120,1154,1067,1141,1062,2203,115,No,4.96%,4,0%,20,0.86%
38097,North Dakota,Traill County,8072,4064,4008,3935,3887,3829,3788,7617,455,No,5.64%,44,1%,219,2.71%
38099,North Dakota,Walsh County,11046,5602,5444,5411,5251,4844,4797,9641,1405,No,12.72%,34,0%,1078,9.76%
38101,North Dakota,Ward County,64798,33487,31311,30236,28475,29077,27600,56677,8121,No,12.53%,1973,3%,2471,3.81%
38103,North Dakota,Wells County,4271,2116,2155,2070,2116,2061,2100,4161,110,No,2.58%,6,0%,30,0.70%
38105,North Dakota,Williams County,26697,14205,12492,13108,11484,12707,11191,23898,2799,No,10.48%,201,1%,823,3.08%
39001,Ohio,Adams County,28350,14019,14331,13673,14002,13564,13900,27464,886,No,3.13%,123,0%,234,0.83%
39003,Ohio,Allen County,105141,52997,52144,44420,44104,43205,43209,86414,18727,No,17.81%,12809,12%,2662,2.53%
39005,Ohio,Ashland County,52962,25920,27042,25204,26360,24947,26114,51061,1901,No,3.59%,437,1%,563,1.06%
39007,Ohio,Ashtabula County,100389,50296,50093,46388,47448,44764,46031,90795,9594,No,9.56%,3794,4%,3538,3.52%
39009,Ohio,Athens County,64304,32082,32222,29437,29655,28985,29186,58171,6133,No,9.54%,1783,3%,1131,1.76%
39011,Ohio,Auglaize County,45831,22763,23068,22264,22614,21997,22387,44384,1447,No,3.16%,185,0%,581,1.27%
39013,Ohio,Belmont County,69671,35328,34343,32421,33072,32166,32882,65048,4623,No,6.64%,2863,4%,514,0.74%
39015,Ohio,Brown County,44381,21962,22419,21387,21890,21241,21747,42988,1393,No,3.14%,421,1%,311,0.70%
39017,Ohio,Butler County,370589,181668,188921,158648,164431,151685,158378,310063,60526,No,16.33%,29081,8%,15435,4.16%
39019,Ohio,Carroll County,28587,14274,14313,13960,13989,13847,13854,27701,886,No,3.10%,159,1%,290,1.01%
39021,Ohio,Champaign County,39565,19607,19958,18568,19009,18335,18797,37132,2433,No,6.15%,913,2%,522,1.32%
39023,Ohio,Clark County,137206,66487,70719,58074,61871,56278,60410,116688,20518,No,14.95%,12322,9%,3954,2.88%
39025,Ohio,Clermont County,199085,98046,101039,94101,97100,92589,95698,188287,10798,No,5.42%,2648,1%,3257,1.64%
39027,Ohio,Clinton County,41886,20575,21311,19497,20298,19168,20065,39233,2653,No,6.33%,965,2%,671,1.60%
39029,Ohio,Columbiana County,106507,53606,52901,50640,51380,49892,50981,100873,5634,No,5.29%,2537,2%,1453,1.36%
39031,Ohio,Coshocton County,36779,18201,18578,17724,18041,17584,17900,35484,1295,No,3.52%,411,1%,315,0.86%
39033,Ohio,Crawford County,42849,20772,22077,20149,21554,19910,21325,41235,1614,No,3.77%,399,1%,542,1.26%
39035,Ohio,Cuyahoga County,1265111,601223,663888,397039,422971,372154,398109,770263,494848,No,39.11%,381864,30%,64271,5.08%
39037,Ohio,Darke County,52507,25798,26709,25278,26142,24930,25841,50771,1736,No,3.31%,288,1%,704,1.34%
39039,Ohio,Defiance County,38677,19074,19603,18241,18801,16536,17215,33751,4926,No,12.74%,807,2%,3604,9.32%
39041,Ohio,Delaware County,181061,89530,91531,80268,82345,78443,80557,159000,22061,No,12.18%,6308,3%,4110,2.27%
39043,Ohio,Erie County,76398,37299,39099,32668,34283,31465,33204,64669,11729,No,15.35%,6658,9%,2780,3.64%
39045,Ohio,Fairfield County,147474,73060,74414,65715,67294,64529,66193,130722,16752,No,11.36%,9514,6%,2745,1.86%
39047,Ohio,Fayette County,28880,14229,14651,13479,13993,13248,13789,27037,1843,No,6.38%,652,2%,536,1.86%
39049,Ohio,Franklin County,1195537,582600,612937,415731,429809,390241,407582,797823,397714,No,33.27%,260741,22%,59529,4.98%
39051,Ohio,Fulton County,42513,20846,21667,20328,21124,18708,19576,38284,4229,No,9.95%,272,1%,3404,8.01%
39053,Ohio,Gallia County,30708,15159,15549,14280,14868,14156,14765,28921,1787,No,5.82%,797,3%,296,0.96%
39055,Ohio,Geauga County,93680,46153,47527,44842,46113,44331,45607,89938,3742,No,3.99%,1248,1%,1112,1.19%
39057,Ohio,Greene County,163587,80217,83370,69549,71760,67907,70202,138109,25478,No,15.57%,12493,8%,3941,2.41%
39059,Ohio,Guernsey County,39817,19563,20254,18729,19516,18583,19347,37930,1887,No,4.74%,605,2%,380,0.95%
39061,Ohio,Hamilton County,802038,385747,416291,272207,284990,263040,276848,539888,262150,No,32.69%,207581,26%,21968,2.74%
39063,Ohio,Hancock County,75671,36940,38731,34927,36828,33285,35213,68498,7173,No,9.48%,1267,2%,3649,4.82%
39065,Ohio,Hardin County,31627,15697,15930,15198,15455,14977,15301,30278,1349,No,4.27%,277,1%,449,1.42%
39067,Ohio,Harrison County,15714,7771,7943,7433,7632,7391,7587,14978,736,No,4.68%,346,2%,110,0.70%
39069,Ohio,Henry County,28045,13876,14169,13544,13854,12613,12966,25579,2466,No,8.79%,164,1%,1924,6.86%
39071,Ohio,Highland County,42998,21057,21941,20330,21185,20213,21042,41255,1743,No,4.05%,625,1%,326,0.76%
39073,Ohio,Hocking County,29273,14693,14580,14291,14249,14202,14152,28354,919,No,3.14%,241,1%,223,0.76%
39075,Ohio,Holmes County,43025,21421,21604,21140,21368,20965,21216,42181,844,No,1.96%,175,0%,367,0.85%
39077,Ohio,Huron County,59280,29121,30159,28098,29165,26419,27627,54046,5234,No,8.83%,734,1%,3493,5.89%
39079,Ohio,Jackson County,32954,16184,16770,15685,16336,15551,16204,31755,1199,No,3.64%,225,1%,294,0.89%
39081,Ohio,Jefferson County,68389,32972,35417,30332,32621,30036,32220,62256,6133,No,8.97%,3809,6%,823,1.20%
39083,Ohio,Knox County,60705,29694,31011,28808,30063,28417,29717,58134,2571,No,4.24%,557,1%,809,1.33%
39085,Ohio,Lake County,229582,111995,117587,104813,109945,100694,106550,207244,22338,No,9.73%,8188,4%,8345,3.63%
39087,Ohio,Lawrence County,62109,30273,31836,28941,30570,28727,30355,59082,3027,No,4.87%,1364,2%,509,0.82%
39089,Ohio,Licking County,167537,81972,85565,76462,79957,75422,78847,154269,13268,No,7.92%,6090,4%,2518,1.50%
39091,Ohio,Logan County,45474,22375,23099,21309,22058,21038,21830,42868,2606,No,5.73%,781,2%,573,1.26%
39093,Ohio,Lorain County,301478,148304,153174,128548,134034,117629,123309,240938,60540,No,20.08%,26512,9%,26154,8.68%
39095,Ohio,Lucas County,437998,212357,225641,161747,169879,150380,158598,308978,129020,No,29.46%,85446,20%,27918,6.37%
39097,Ohio,Madison County,43053,23402,19651,20409,18771,20093,18549,38642,4411,No,10.25%,2803,7%,636,1.48%
39099,Ohio,Mahoning County,235145,114060,121085,92706,97761,87664,93858,181522,53623,No,22.80%,37665,16%,11724,4.99%
39101,Ohio,Marion County,66238,35075,31163,31040,29454,30287,28900,59187,7051,No,10.64%,4151,6%,1552,2.34%
39103,Ohio,Medina County,173684,85704,87980,82466,84716,81056,83393,164449,9235,No,5.32%,2263,1%,3039,1.75%
39105,Ohio,Meigs County,23593,11576,12017,11278,11733,11229,11680,22909,684,No,2.90%,206,1%,115,0.49%
39107,Ohio,Mercer County,40875,20517,20358,20060,19916,19782,19634,39416,1459,No,3.57%,143,0%,653,1.60%
39109,Ohio,Miami County,103060,50732,52328,47922,49620,47236,48994,96230,6830,No,6.63%,2193,2%,1477,1.43%
39111,Ohio,Monroe County,14549,7306,7243,7172,7093,7140,7065,14205,344,No,2.36%,71,0%,72,0.49%
39113,Ohio,Montgomery County,534325,257040,277285,193379,204275,187850,199214,387064,147261,No,27.56%,112480,21%,13081,2.45%
39115,Ohio,Morgan County,14911,7426,7485,6942,6977,6902,6947,13849,1062,No,7.12%,440,3%,107,0.72%
39117,Ohio,Morrow County,34938,17400,17538,16982,17140,16762,16971,33733,1205,No,3.45%,168,0%,435,1.25%
39119,Ohio,Muskingum County,85950,41619,44331,38567,41352,38289,41075,79364,6586,No,7.66%,3354,4%,714,0.83%
39121,Ohio,Noble County,14579,8459,6120,7997,5999,7956,5977,13933,646,No,4.43%,393,3%,67,0.46%
39123,Ohio,Ottawa County,41339,20458,20881,19901,20310,18989,19454,38443,2896,No,7.01%,398,1%,1893,4.58%
39125,Ohio,Paulding County,19295,9593,9702,9282,9412,8914,9065,17979,1316,No,6.82%,200,1%,859,4.45%
39127,Ohio,Perry County,36015,17992,18023,17593,17630,17511,17510,35021,994,No,2.76%,145,0%,249,0.69%
39129,Ohio,Pickaway County,56399,29715,26684,27328,25918,26992,25669,52661,3738,No,6.63%,2056,4%,660,1.17%
39131,Ohio,Pike County,28480,14153,14327,13651,13841,13564,13766,27330,1150,No,4.04%,280,1%,220,0.77%
39133,Ohio,Portage County,161451,78865,82586,72910,75921,71895,74923,146818,14633,No,9.06%,7116,4%,2356,1.46%
39135,Ohio,Preble County,41886,20835,21051,20297,20557,20174,20436,40610,1276,No,3.05%,219,1%,276,0.66%
39137,Ohio,Putnam County,34198,17103,17095,16815,16805,15900,15972,31872,2326,No,6.80%,154,0%,1932,5.65%
39139,Ohio,Richland County,122673,62127,60546,53201,54559,52372,53794,106166,16507,No,13.46%,11480,9%,1885,1.54%
39141,Ohio,Ross County,77429,40577,36852,35947,34619,35569,34320,69889,7540,No,9.74%,4651,6%,849,1.10%
39143,Ohio,Sandusky County,60510,29866,30644,28059,28915,25464,26404,51868,8642,No,14.28%,1851,3%,5570,9.21%
39145,Ohio,Scioto County,78477,38700,39777,36170,38107,35769,37742,73511,4966,No,6.33%,2136,3%,914,1.16%
39147,Ohio,Seneca County,56018,28005,28013,26470,26702,25258,25629,50887,5131,No,9.16%,1420,3%,2631,4.70%
39149,Ohio,Shelby County,49167,24579,24588,23256,23428,22919,23140,46059,3108,No,6.32%,999,2%,697,1.42%
39151,Ohio,Stark County,374868,181525,193343,161360,172205,158581,169641,328222,46646,No,12.44%,28862,8%,6504,1.74%
39153,Ohio,Summit County,540811,261799,279012,212254,223495,208460,219818,428278,112533,No,20.81%,79145,15%,9535,1.76%
39155,Ohio,Trumbull County,207406,100889,106517,90000,94831,88805,93595,182400,25006,No,12.06%,17517,8%,3087,1.49%
39157,Ohio,Tuscarawas County,92392,45534,46858,44044,45618,43202,45032,88234,4158,No,4.50%,762,1%,1936,2.10%
39159,Ohio,Union County,52715,25181,27534,23671,25386,23385,25078,48463,4252,No,8.07%,1310,2%,700,1.33%
39161,Ohio,Van Wert County,28744,14015,14729,13593,14379,13243,14028,27271,1473,No,5.12%,279,1%,782,2.72%
39163,Ohio,Vinton County,13239,6586,6653,6438,6508,6395,6470,12865,374,No,2.82%,53,0%,91,0.69%
39165,Ohio,Warren County,217241,108939,108302,97747,99067,95390,96736,192126,25115,No,11.56%,7424,3%,5221,2.40%
39167,Ohio,Washington County,61475,30068,31407,28940,30366,28724,30129,58853,2622,No,4.27%,738,1%,529,0.86%
39169,Ohio,Wayne County,114848,56840,58008,54464,55807,53568,55057,108625,6223,No,5.42%,1807,2%,1864,1.62%
39171,Ohio,Williams County,37513,18620,18893,17962,18448,17261,17780,35041,2472,No,6.59%,403,1%,1482,3.95%
39173,Ohio,Wood County,128200,62767,65433,58904,61439,56080,58591,114671,13529,No,10.55%,3307,3%,6328,4.94%
39175,Ohio,Wyandot County,22607,11170,11437,10900,11203,10613,11005,21618,989,No,4.37%,77,0%,560,2.48%
40001,Oklahoma,Adair County,22286,11141,11145,4967,4913,4688,4660,9348,12938,Yes,58.05%,94,0%,1242,5.57%
40003,Oklahoma,Alfalfa County,5666,3377,2289,2897,2172,2735,2103,4838,828,No,14.61%,246,4%,282,4.98%
40005,Oklahoma,Atoka County,14007,7293,6714,5405,5032,5221,4908,10129,3878,No,27.69%,533,4%,484,3.46%
40007,Oklahoma,Beaver County,5591,2812,2779,2665,2637,2094,2113,4207,1384,No,24.75%,54,1%,1186,21.21%
40009,Oklahoma,Beckham County,23081,12291,10790,10742,9809,8963,8951,17914,5167,No,22.39%,966,4%,2970,12.87%
40011,Oklahoma,Blaine County,9785,4834,4951,4001,4094,3669,3780,7449,2336,No,23.87%,319,3%,828,8.46%
40013,Oklahoma,Bryan County,43399,21216,22183,16284,17167,15327,16367,31694,11705,No,26.97%,741,2%,2252,5.19%
40015,Oklahoma,Caddo County,29678,15433,14245,10171,9124,8986,8437,17423,12255,No,41.29%,883,3%,3130,10.55%
40017,Oklahoma,Canadian County,122560,60718,61842,51462,52879,47331,49223,96554,26006,No,21.22%,3307,3%,9156,7.47%
40019,Oklahoma,Carter County,48085,23561,24524,17915,18623,16798,17598,34396,13689,No,28.47%,3392,7%,2876,5.98%
40021,Oklahoma,Cherokee County,48150,23797,24353,12888,13237,11707,12330,24037,24113,Yes,50.08%,681,1%,3098,6.43%
40023,Oklahoma,Choctaw County,15182,7370,7812,4780,5073,4577,4943,9520,5662,No,37.29%,1661,11%,495,3.26%
40025,Oklahoma,Cimarron County,2385,1189,1196,1144,1158,891,944,1835,550,No,23.06%,8,0%,478,20.04%
40027,Oklahoma,Cleveland County,265638,132772,132866,106899,107809,98280,99748,198028,67610,No,25.45%,12218,5%,19952,7.51%
40029,Oklahoma,Coal County,5963,2911,3052,2133,2248,2071,2203,4274,1689,No,28.32%,52,1%,177,2.97%
40031,Oklahoma,Comanche County,126390,65658,60732,44368,40163,38454,34978,73432,52958,No,41.90%,22376,18%,15117,11.96%
40033,Oklahoma,Cotton County,6155,3058,3097,2513,2505,2379,2390,4769,1386,No,22.52%,144,2%,421,6.84%
40035,Oklahoma,Craig County,14748,7528,7220,4945,4912,4787,4794,9581,5167,No,35.04%,464,3%,410,2.78%
40037,Oklahoma,Creek County,70651,34936,35715,27959,28719,26988,27779,54767,15884,No,22.48%,1706,2%,2510,3.55%
40039,Oklahoma,Custer County,28536,14187,14349,11958,12179,9966,10373,20339,8197,No,28.73%,940,3%,4416,15.48%
40041,Oklahoma,Delaware County,41441,20470,20971,13738,14193,13315,13753,27068,14373,No,34.68%,137,0%,1281,3.09%
40043,Oklahoma,Dewey County,4783,2355,2428,2110,2179,1980,2086,4066,717,No,14.99%,20,0%,266,5.56%
40045,Oklahoma,Ellis County,4104,2025,2079,1931,1993,1781,1854,3635,469,No,11.43%,21,1%,300,7.31%
40047,Oklahoma,Garfield County,61189,30254,30935,26372,27109,23707,24635,48342,12847,No,21.00%,1931,3%,5997,9.80%
40049,Oklahoma,Garvin County,27297,13423,13874,11172,11575,10366,10892,21258,6039,No,22.12%,752,3%,1829,6.70%
40051,Oklahoma,Grady County,53118,26406,26712,22914,23186,21840,22177,44017,9101,No,17.13%,1318,2%,2667,5.02%
40053,Oklahoma,Grant County,4516,2242,2274,2104,2114,2016,2049,4065,451,No,9.99%,55,1%,179,3.96%
40055,Oklahoma,Greer County,6082,3470,2612,2837,2385,2546,2148,4694,1388,No,22.82%,453,7%,631,10.37%
40057,Oklahoma,Harmon County,2906,1410,1496,1207,1286,878,930,1808,1098,No,37.78%,219,8%,748,25.74%
40059,Oklahoma,Harper County,3676,1824,1852,1752,1787,1416,1477,2893,783,No,21.30%,11,0%,690,18.77%
40061,Oklahoma,Haskell County,12938,6432,6506,4874,4885,4665,4766,9431,3507,No,27.11%,79,1%,439,3.39%
40063,Oklahoma,Hughes County,13836,7404,6432,4927,4547,4674,4399,9073,4763,No,34.42%,763,6%,592,4.28%
40065,Oklahoma,Jackson County,26237,13112,13125,11014,11037,8463,8525,16988,9249,No,35.25%,2097,8%,5749,21.91%
40067,Oklahoma,Jefferson County,6377,3183,3194,2784,2807,2513,2577,5090,1287,No,20.18%,61,1%,555,8.70%
40069,Oklahoma,Johnston County,11003,5395,5608,4012,4150,3834,3993,7827,3176,No,28.86%,226,2%,485,4.41%
40071,Oklahoma,Kay County,45831,22646,23185,18477,18987,17115,17861,34976,10855,No,23.68%,1009,2%,3194,6.97%
40073,Oklahoma,Kingfisher County,15005,7456,7549,6858,6917,5822,6026,11848,3157,No,21.04%,218,1%,2104,14.02%
40075,Oklahoma,Kiowa County,9310,4628,4682,3930,3928,3571,3548,7119,2191,No,23.53%,427,5%,902,9.69%
40077,Oklahoma,Latimer County,11019,5603,5416,3919,3792,3819,3720,7539,3480,No,31.58%,117,1%,326,2.96%
40079,Oklahoma,Le Flore County,49873,24989,24884,19464,19607,17865,18317,36182,13691,No,27.45%,1106,2%,3436,6.89%
40081,Oklahoma,Lincoln County,34189,16979,17210,14622,14834,14296,14489,28785,5404,No,15.81%,597,2%,873,2.55%
40083,Oklahoma,Logan County,43666,21580,22086,17880,18217,16880,17214,34094,9572,No,21.92%,4055,9%,2389,5.47%
40085,Oklahoma,Love County,9558,4734,4824,4071,4097,3522,3626,7148,2410,No,25.21%,191,2%,1224,12.81%
40087,Oklahoma,McClain County,35613,17723,17890,15368,15544,14102,14465,28567,7046,No,19.78%,289,1%,2602,7.31%
40089,Oklahoma,McCurtain County,33203,16283,16920,11096,11431,10495,10906,21401,11802,No,35.54%,2904,9%,1641,4.94%
40091,Oklahoma,McIntosh County,20584,10216,10368,7178,7332,7039,7160,14199,6385,No,31.02%,680,3%,458,2.23%
40093,Oklahoma,Major County,7683,3775,3908,3538,3633,3250,3390,6640,1043,No,13.58%,68,1%,628,8.17%
40095,Oklahoma,Marshall County,15957,7941,8016,6455,6536,5335,5496,10831,5126,No,32.12%,296,2%,2425,15.20%
40097,Oklahoma,Mayes County,41168,20461,20707,13889,14129,13462,13714,27176,13992,No,33.99%,215,1%,1224,2.97%
40099,Oklahoma,Murray County,13663,6835,6828,5393,5393,5116,5137,10253,3410,No,24.96%,226,2%,719,5.26%
40101,Oklahoma,Muskogee County,70596,34485,36111,21157,22248,19708,21024,40732,29864,No,42.30%,7924,11%,3880,5.50%
40103,Oklahoma,Noble County,11522,5695,5827,4835,4921,4725,4803,9528,1994,No,17.31%,206,2%,326,2.83%
40105,Oklahoma,Nowata County,10611,5208,5403,3635,3736,3543,3619,7162,3449,No,32.50%,224,2%,301,2.84%
40107,Oklahoma,Okfuskee County,12358,6582,5776,4259,3755,4107,3631,7738,4620,No,37.38%,989,8%,433,3.50%
40109,Oklahoma,Oklahoma County,741781,363677,378104,263797,268831,210984,222738,433722,308059,No,41.53%,116741,16%,116932,15.76%
40111,Oklahoma,Okmulgee County,39625,19645,19980,12963,13274,12500,12838,25338,14287,No,36.06%,3473,9%,1373,3.46%
40113,Oklahoma,Osage County,47917,24121,23796,16074,15700,15516,15292,30808,17109,No,35.71%,5564,12%,1490,3.11%
40115,Oklahoma,Ottawa County,32236,15838,16398,11180,11624,10565,11049,21614,10622,No,32.95%,335,1%,1584,4.91%
40117,Oklahoma,Pawnee County,16474,8209,8265,6586,6663,6426,6519,12945,3529,No,21.42%,132,1%,405,2.46%
40119,Oklahoma,Payne County,78399,39995,38404,32408,31756,30990,30600,61590,16809,No,21.44%,3015,4%,3234,4.13%
40121,Oklahoma,Pittsburg County,45048,22905,22143,16695,16562,15924,15991,31915,13133,No,29.15%,1617,4%,1938,4.30%
40123,Oklahoma,Pontotoc County,37958,18479,19479,13124,14016,12479,13494,25973,11985,No,31.57%,925,2%,1623,4.28%
40125,Oklahoma,Pottawatomie County,70760,33838,36922,26016,28351,24972,27331,52303,18457,No,26.08%,2154,3%,3138,4.43%
40127,Oklahoma,Pushmataha County,11205,5472,5733,4119,4308,3999,4197,8196,3009,No,26.85%,99,1%,321,2.86%
40129,Oklahoma,Roger Mills County,3774,1898,1876,1740,1698,1636,1623,3259,515,No,13.65%,22,1%,215,5.70%
40131,Oklahoma,Rogers County,88367,43965,44402,33565,33935,32176,32600,64776,23591,No,26.70%,995,1%,3554,4.02%
40133,Oklahoma,Seminole County,25450,12484,12966,8492,8919,8168,8605,16773,8677,No,34.09%,1181,5%,1020,4.01%
40135,Oklahoma,Sequoyah County,41398,20448,20950,13674,14103,13113,13660,26773,14625,No,35.33%,772,2%,1514,3.66%
40137,Oklahoma,Stephens County,44779,21824,22955,19132,20002,17875,18834,36709,8070,No,18.02%,896,2%,2907,6.49%
40139,Oklahoma,Texas County,21498,11283,10215,10130,9405,5260,5191,10451,11047,Yes,51.39%,548,3%,9694,45.09%
40141,Oklahoma,Tillman County,7822,3912,3910,3270,3287,2440,2495,4935,2887,No,36.91%,643,8%,1859,23.77%
40143,Oklahoma,Tulsa County,613816,299168,314648,223295,232418,191595,204885,396480,217336,No,35.41%,66636,11%,70124,11.42%
40145,Oklahoma,Wagoner County,75030,37050,37980,28583,29320,26974,27765,54739,20291,No,27.04%,2873,4%,3861,5.15%
40147,Oklahoma,Washington County,51633,25005,26628,19668,21136,18501,20043,38544,13089,No,25.35%,1479,3%,2800,5.42%
40149,Oklahoma,Washita County,11622,5750,5872,5258,5374,4831,4984,9815,1807,No,15.55%,118,1%,1041,8.96%
40151,Oklahoma,Woods County,8832,4727,4105,4165,3835,3943,3666,7609,1223,No,13.85%,294,3%,463,5.24%
40153,Oklahoma,Woodward County,20548,10826,9722,9756,9082,8653,8218,16871,3677,No,17.89%,370,2%,2237,10.89%
41001,Oregon,Baker County,15909,8065,7844,7697,7480,7431,7234,14665,1244,No,7.82%,67,0%,584,3.67%
41003,Oregon,Benton County,86430,43375,43055,38328,38338,35787,35843,71630,14800,No,17.12%,918,1%,5823,6.74%
41005,Oregon,Clackamas County,383857,189109,194748,171967,176720,158098,163966,322064,61793,No,16.10%,3779,1%,30956,8.06%
41007,Oregon,Clatsop County,37301,18515,18786,17361,17620,16043,16355,32398,4903,No,13.14%,252,1%,2939,7.88%
41009,Oregon,Columbia County,49286,24631,24655,23088,22996,22166,22114,44280,5006,No,10.16%,245,0%,2161,4.38%
41011,Oregon,Coos County,62534,30849,31685,28208,28859,26688,27395,54083,8451,No,13.51%,305,0%,3605,5.76%
41013,Oregon,Crook County,20729,10245,10484,9828,10021,9080,9356,18436,2293,No,11.06%,47,0%,1557,7.51%
41015,Oregon,Curry County,22248,10965,11283,10247,10491,9646,9950,19596,2652,No,11.92%,91,0%,1324,5.95%
41017,Oregon,Deschutes County,162277,80003,82274,76025,78000,70633,72451,143084,19193,No,11.83%,681,0%,12389,7.63%
41019,Oregon,Douglas County,107164,52909,54255,49418,50547,47116,48347,95463,11701,No,10.92%,429,0%,5261,4.91%
41021,Oregon,Gilliam County,1953,996,957,950,921,898,875,1773,180,No,9.22%,4,0%,107,5.48%
41023,Oregon,Grant County,7317,3641,3676,3465,3508,3374,3393,6767,550,No,7.52%,22,0%,244,3.33%
41025,Oregon,Harney County,7212,3662,3550,3400,3288,3250,3152,6402,810,No,11.23%,26,0%,324,4.49%
41027,Oregon,Hood River County,22584,11319,11265,10668,10573,7177,7541,14718,7866,No,34.83%,158,1%,6814,30.17%
41029,Oregon,Jackson County,206412,100633,105779,93375,98374,82567,88502,171069,35343,No,17.12%,1628,1%,23498,11.38%
41031,Oregon,Jefferson County,21749,11311,10438,8696,7960,6884,6348,13232,8517,No,39.16%,220,1%,4301,19.78%
41033,Oregon,Josephine County,82930,40456,42474,37945,39853,35580,37595,73175,9755,No,11.76%,397,0%,5501,6.63%
41035,Oregon,Klamath County,65912,32882,33030,29461,29648,26227,26707,52934,12978,No,19.69%,525,1%,7294,11.07%
41037,Oregon,Lake County,7771,4126,3645,3832,3389,3584,3125,6709,1062,No,13.67%,42,1%,585,7.53%
41039,Oregon,Lane County,354542,174252,180290,157819,163462,145936,151992,297928,56614,No,15.97%,3754,1%,27667,7.80%
41041,Oregon,Lincoln County,46151,22463,23688,20246,21421,18649,19997,38646,7505,No,16.26%,308,1%,3788,8.21%
41043,Oregon,Linn County,118360,58512,59848,54776,56006,50432,52144,102576,15784,No,13.34%,749,1%,9573,8.09%
41045,Oregon,Malheur County,30630,16580,14050,15233,13086,10274,8877,19151,11479,No,37.48%,427,1%,9941,32.46%
41047,Oregon,Marion County,319985,159563,160422,143246,144721,105881,111155,217036,102949,No,32.17%,4333,1%,80265,25.08%
41049,Oregon,Morrow County,11244,5775,5469,5448,5151,3544,3548,7092,4152,No,36.93%,101,1%,3719,33.08%
41051,Oregon,Multnomah County,759256,375330,383926,304734,309373,268444,277083,545527,213729,No,28.15%,43746,6%,84262,11.10%
41053,Oregon,Polk County,76353,37037,39316,33667,35862,29249,31728,60977,15376,No,20.14%,546,1%,9650,12.64%
41055,Oregon,Sherman County,1732,871,861,832,826,784,778,1562,170,No,9.82%,5,0%,114,6.58%
41057,Oregon,Tillamook County,25287,12741,12546,12056,11869,10936,10859,21795,3492,No,13.81%,128,1%,2379,9.41%
41059,Oregon,Umatilla County,76820,40119,36701,36489,33443,27015,25508,52523,24297,No,31.63%,789,1%,19006,24.74%
41061,Oregon,Union County,25759,12704,13055,11885,12277,11396,11830,23226,2533,No,9.83%,136,1%,1094,4.25%
41063,Oregon,Wallowa County,6821,3357,3464,3248,3319,3175,3252,6427,394,No,5.78%,29,0%,162,2.38%
41065,Oregon,Wasco County,25487,12654,12833,11495,11714,9498,10004,19502,5985,No,23.48%,158,1%,4065,15.95%
41067,Oregon,Washington County,547672,269988,277684,224151,230623,184252,193163,377415,170257,No,31.09%,11486,2%,87789,16.03%
41069,Oregon,Wheeler County,1424,719,705,680,659,643,639,1282,142,No,9.97%,0,0%,65,4.56%
41071,Oregon,Yamhill County,100255,50355,49900,46151,46254,38588,40076,78664,21591,No,21.54%,1033,1%,15351,15.31%
42001,Pennsylvania,Adams County,101482,49977,51505,47923,49467,44761,46897,91658,9824,No,9.68%,1798,2%,6343,6.25%
42003,Pennsylvania,Allegheny County,1229338,590492,638846,483798,518237,475401,510245,985646,243692,No,19.82%,164288,13%,21733,1.77%
42005,Pennsylvania,Armstrong County,68409,33869,34540,33182,33887,33013,33692,66705,1704,No,2.49%,572,1%,435,0.64%
42007,Pennsylvania,Beaver County,170245,82348,87897,75233,80204,74342,79250,153592,16653,No,9.78%,10812,6%,2197,1.29%
42009,Pennsylvania,Bedford County,49324,24559,24765,24076,24311,23840,24149,47989,1335,No,2.71%,288,1%,488,0.99%
42011,Pennsylvania,Berks County,413491,203075,210416,181077,188240,152578,160187,312765,100726,No,24.36%,26350,6%,72258,17.48%
42013,Pennsylvania,Blair County,127121,61830,65291,59237,63027,58675,62535,121210,5911,No,4.65%,2279,2%,1332,1.05%
42015,Pennsylvania,Bradford County,62792,31062,31730,30233,30932,29874,30611,60485,2307,No,3.67%,376,1%,826,1.32%
42017,Pennsylvania,Bucks County,627053,307462,319591,277146,287614,264373,275890,540263,86790,No,13.84%,24398,4%,28566,4.56%
42019,Pennsylvania,Butler County,184970,91206,93764,87977,90814,86943,89911,176854,8116,No,4.39%,2256,1%,2194,1.19%
42021,Pennsylvania,Cambria County,141584,70141,71443,65329,67972,64361,67280,131641,9943,No,7.02%,5403,4%,2174,1.54%
42023,Pennsylvania,Cameron County,4939,2415,2524,2377,2470,2370,2456,4826,113,No,2.29%,16,0%,27,0.55%
42025,Pennsylvania,Carbon County,65006,32133,32873,30915,31725,29857,30756,60613,4393,No,6.76%,1132,2%,2387,3.67%
42027,Pennsylvania,Centre County,155171,80537,74634,71656,67416,69863,65921,135784,19387,No,12.49%,5032,3%,4038,2.60%
42029,Pennsylvania,Chester County,506575,248946,257629,217793,224991,201272,211451,412723,93852,No,18.53%,32237,6%,34471,6.80%
42031,Pennsylvania,Clarion County,39646,19302,20344,18761,19828,18649,19733,38382,1264,No,3.19%,434,1%,265,0.67%
42033,Pennsylvania,Clearfield County,81184,41960,39224,39325,38512,38026,38251,76277,4907,No,6.04%,2100,3%,2049,2.52%
42035,Pennsylvania,Clinton County,39517,19396,20121,18726,19494,18491,19305,37796,1721,No,4.36%,673,2%,472,1.19%
42037,Pennsylvania,Columbia County,66887,32110,34777,30760,33368,30134,32753,62887,4000,No,5.98%,1321,2%,1544,2.31%
42039,Pennsylvania,Crawford County,87598,42842,44756,41390,42974,41034,42533,83567,4031,No,4.60%,1596,2%,954,1.09%
42041,Pennsylvania,Cumberland County,238614,117315,121299,106041,111406,102807,108789,211596,27018,No,11.32%,8350,3%,7267,3.05%
42043,Pennsylvania,Dauphin County,269665,130558,139107,97915,103359,90643,96236,186879,82786,No,30.70%,50258,19%,20323,7.54%
42045,Pennsylvania,Delaware County,561098,269280,291818,196753,208828,190093,202745,392838,168260,No,29.99%,115627,21%,18025,3.21%
42047,Pennsylvania,Elk County,31550,15749,15801,15499,15571,15404,15476,30880,670,No,2.12%,125,0%,217,0.69%
42049,Pennsylvania,Erie County,280646,138209,142437,122448,127416,118301,123574,241875,38771,No,13.81%,20808,7%,10170,3.62%
42051,Pennsylvania,Fayette County,135660,66690,68970,61713,64948,61163,64557,125720,9940,No,7.33%,6417,5%,1254,0.92%
42053,Pennsylvania,Forest County,7667,5160,2507,3655,2449,3315,2420,5735,1932,No,25.20%,1455,19%,434,5.66%
42055,Pennsylvania,Franklin County,151275,73993,77282,68931,72326,65975,69691,135666,15609,No,10.32%,5465,4%,7029,4.65%
42057,Pennsylvania,Fulton County,14772,7433,7339,7240,7146,7182,7091,14273,499,No,3.38%,164,1%,140,0.95%
42059,Pennsylvania,Greene County,38085,19667,18418,18195,18002,17918,17907,35825,2260,No,5.93%,1273,3%,475,1.25%
42061,Pennsylvania,Huntingdon County,45943,24385,21558,21644,20981,21192,20823,42015,3928,No,8.55%,2541,6%,785,1.71%
42063,Pennsylvania,Indiana County,88218,43891,44327,41438,42488,40966,42082,83048,5170,No,5.86%,2397,3%,1111,1.26%
42065,Pennsylvania,Jefferson County,44764,22177,22587,21798,22173,21669,22039,43708,1056,No,2.36%,203,0%,322,0.72%
42067,Pennsylvania,Juniata County,24904,12438,12466,12167,12190,11868,11946,23814,1090,No,4.38%,181,1%,653,2.62%
42069,Pennsylvania,Lackawanna County,214477,103406,111071,96133,104015,91202,99318,190520,23957,No,11.17%,6429,3%,11851,5.53%
42071,Pennsylvania,Lancaster County,526823,257483,269340,234505,246527,215496,227426,442922,83901,No,15.93%,23745,5%,48848,9.27%
42073,Pennsylvania,Lawrence County,89871,43247,46624,40566,43780,40187,43357,83544,6327,No,7.04%,3562,4%,984,1.09%
42075,Pennsylvania,Lebanon County,135251,66105,69146,62106,65169,56333,59416,115749,19502,No,14.42%,3972,3%,14117,10.44%
42077,Pennsylvania,Lehigh County,355245,172778,182467,147401,156567,119406,128574,247980,107265,No,30.19%,28322,8%,71944,20.25%
42079,Pennsylvania,Luzerne County,321027,157613,163414,144747,152840,134727,143379,278106,42921,No,13.37%,13895,4%,25764,8.03%
42081,Pennsylvania,Lycoming County,117168,57587,59581,53499,55101,52844,54377,107221,9947,No,8.49%,5499,5%,1821,1.55%
42083,Pennsylvania,McKean County,43127,21948,21179,20677,20663,20126,20482,40608,2519,No,5.84%,1057,2%,827,1.92%
42085,Pennsylvania,Mercer County,115655,56704,58951,51803,54420,51202,53960,105162,10493,No,9.07%,6681,6%,1333,1.15%
42087,Pennsylvania,Mifflin County,46773,22972,23801,22463,23275,22217,23049,45266,1507,No,3.22%,326,1%,546,1.17%
42089,Pennsylvania,Monroe County,168798,83272,85526,67121,68477,58069,59167,117236,51562,No,30.55%,24400,14%,23574,13.97%
42091,Pennsylvania,Montgomery County,808460,392314,416146,321556,340645,305409,326883,632292,176168,No,21.79%,73676,9%,36452,4.51%
42093,Pennsylvania,Montour County,18356,8798,9558,8281,9116,8123,8947,17070,1286,No,7.01%,289,2%,380,2.07%
42095,Pennsylvania,Northampton County,299267,146605,152662,130454,136186,116535,122448,238983,60284,No,20.14%,17793,6%,33724,11.27%
42097,Pennsylvania,Northumberland County,94428,47240,47188,44722,45867,43675,44889,88564,5864,No,6.21%,2240,2%,2577,2.73%
42099,Pennsylvania,Perry County,45701,22897,22804,22276,22298,21977,22032,44009,1692,No,3.70%,362,1%,684,1.50%
42101,Pennsylvania,Philadelphia County,1547607,730782,816825,345172,361397,274619,291309,565928,981679,Yes,63.43%,685599,44%,201001,12.99%
42103,Pennsylvania,Pike County,56899,28448,28451,25814,25713,23537,23387,46924,9975,No,17.53%,3518,6%,5381,9.46%
42105,Pennsylvania,Potter County,17577,8815,8762,8643,8605,8555,8519,17074,503,No,2.86%,83,0%,200,1.14%
42107,Pennsylvania,Schuylkill County,147063,74743,72320,69871,70256,67606,68749,136355,10708,No,7.28%,4371,3%,4574,3.11%
42109,Pennsylvania,Snyder County,39672,19554,20118,19022,19565,18750,19268,38018,1654,No,4.17%,474,1%,708,1.78%
42111,Pennsylvania,Somerset County,76957,39735,37222,37423,36665,36905,36451,73356,3601,No,4.68%,1976,3%,886,1.15%
42113,Pennsylvania,Sullivan County,6461,3337,3124,3143,3037,3080,3007,6087,374,No,5.79%,183,3%,105,1.63%
42115,Pennsylvania,Susquehanna County,42696,21505,21191,21121,20832,20784,20560,41344,1352,No,3.17%,189,0%,663,1.55%
42117,Pennsylvania,Tioga County,42577,21016,21561,20481,20995,20253,20781,41034,1543,No,3.62%,362,1%,513,1.20%
42119,Pennsylvania,Union County,44952,24766,20186,20653,19318,19139,18988,38127,6825,No,15.18%,3592,8%,2497,5.55%
42121,Pennsylvania,Venango County,54272,26606,27666,25769,26957,25525,26700,52225,2047,No,3.77%,596,1%,560,1.03%
42123,Pennsylvania,Warren County,41146,20544,20602,20131,20227,19968,20077,40045,1101,No,2.68%,186,0%,362,0.88%
42125,Pennsylvania,Washington County,208716,101668,107048,95681,101073,94551,100008,194559,14157,No,6.78%,6864,3%,2667,1.28%
42127,Pennsylvania,Wayne County,51955,27430,24525,25356,23834,24338,23168,47506,4449,No,8.56%,1825,4%,1951,3.76%
42129,Pennsylvania,Westmoreland County,363395,177301,186094,168396,178036,166828,176535,343363,20032,No,5.51%,8944,2%,3665,1.01%
42131,Pennsylvania,Wyoming County,28125,14082,14043,13709,13724,13492,13513,27005,1120,No,3.98%,244,1%,482,1.71%
42133,Pennsylvania,York County,437846,216269,221577,195099,199857,184432,190276,374708,63138,No,14.42%,27098,6%,26603,6.08%
44001,Rhode Island,Bristol County,49144,23609,25535,22545,24512,22092,24049,46141,3003,No,6.11%,458,1%,1090,2.22%
44003,Rhode Island,Kent County,164843,79450,85393,74489,80491,71957,78024,149981,14862,No,9.02%,2796,2%,6041,3.66%
44005,Rhode Island,Newport County,82036,39987,42049,36306,38433,34817,37088,71905,10131,No,12.35%,3200,4%,3764,4.59%
44007,Rhode Island,Providence County,628323,304175,324148,245136,261949,198300,214941,413241,215082,No,34.23%,68981,11%,124239,19.77%
44009,Rhode Island,Washington County,125946,61055,64891,57382,61196,56028,59803,115831,10115,No,8.03%,1688,1%,3415,2.71%
45001,South Carolina,Abbeville County,25101,12182,12919,8650,8892,8515,8782,17297,7804,No,31.09%,7082,28%,297,1.18%
45003,South Carolina,Aiken County,162812,78870,83942,57369,59542,53557,56386,109943,52869,No,32.47%,40565,25%,8344,5.12%
45005,South Carolina,Allendale County,9988,5343,4645,1469,1096,1346,1020,2366,7622,Yes,76.31%,7282,73%,269,2.69%
45007,South Carolina,Anderson County,189355,91398,97957,74290,78796,71618,76386,148004,41351,No,21.84%,31427,17%,5977,3.16%
45009,South Carolina,Bamberg County,15763,7515,8248,2863,2938,2752,2847,5599,10164,Yes,64.48%,9676,61%,308,1.95%
45011,South Carolina,Barnwell County,22212,10594,11618,5769,6038,5554,5910,11464,10748,No,48.39%,9841,44%,465,2.09%
45013,South Carolina,Beaufort County,168049,83008,85041,64695,64687,55113,56709,111822,56227,No,33.46%,32603,19%,19833,11.80%
45015,South Carolina,Berkeley County,189781,94839,94942,66564,64342,61439,60171,121610,68171,No,35.92%,47898,25%,11457,6.04%
45017,South Carolina,Calhoun County,14910,7250,7660,4168,4065,3963,3918,7881,7029,No,47.14%,6379,43%,482,3.23%
45019,South Carolina,Charleston County,365162,177111,188051,121232,123846,112009,117036,229045,136117,No,37.28%,107245,29%,19357,5.30%
45021,South Carolina,Cherokee County,55662,26972,28690,21042,21745,20050,20935,40985,14677,No,26.37%,11465,21%,2154,3.87%
45023,South Carolina,Chester County,32546,15737,16809,9672,9895,9425,9728,19153,13393,No,41.15%,12197,37%,538,1.65%
45025,South Carolina,Chesterfield County,46103,22439,23664,14840,15063,13933,14569,28502,17601,No,38.18%,14962,32%,1713,3.72%
45027,South Carolina,Clarendon County,34357,16910,17447,8429,8325,8019,8035,16054,18303,Yes,53.27%,16974,49%,980,2.85%
45029,South Carolina,Colleton County,38153,18287,19866,11026,11238,10506,10892,21398,16755,No,43.92%,14843,39%,1087,2.85%
45031,South Carolina,Darlington County,68139,32177,35962,18749,19940,18274,19516,37790,30349,No,44.54%,28220,41%,1231,1.81%
45033,South Carolina,Dillon County,31446,14871,16575,7459,7914,7142,7680,14822,16624,Yes,52.87%,14565,46%,832,2.65%
45035,South Carolina,Dorchester County,142496,69298,73198,48462,50040,45652,47459,93111,49385,No,34.66%,36820,26%,6591,4.63%
45037,South Carolina,Edgefield County,26347,14203,12144,8537,7489,7587,7201,14788,11559,No,43.87%,9795,37%,1472,5.59%
45039,South Carolina,Fairfield County,23363,11159,12204,4549,4711,4381,4560,8941,14422,Yes,61.73%,13695,59%,437,1.87%
45041,South Carolina,Florence County,137948,64762,73186,36864,39285,35602,38175,73777,64171,No,46.52%,57841,42%,3276,2.37%
45043,South Carolina,Georgetown County,60189,28661,31528,18953,20179,18095,19540,37635,22554,No,37.47%,20019,33%,1813,3.01%
45045,South Carolina,Greenville County,467605,226868,240737,176314,184398,157748,168234,325982,141623,No,30.29%,86317,18%,39629,8.47%
45047,South Carolina,Greenwood County,69756,32750,37006,21878,23809,20089,22303,42392,27364,No,39.23%,22277,32%,3985,5.71%
45049,South Carolina,Hampton County,20726,10670,10056,4823,4340,4391,4209,8600,12126,Yes,58.51%,11121,54%,799,3.86%
45051,South Carolina,Horry County,282285,137548,144737,114076,119012,105611,112382,217993,64292,No,22.78%,38693,14%,17528,6.21%
45053,South Carolina,Jasper County,25833,13350,12483,7092,6202,5121,4881,10002,15831,Yes,61.28%,11892,46%,3701,14.33%
45055,South Carolina,Kershaw County,62343,30325,32018,22213,22940,21048,21994,43042,19301,No,30.96%,15666,25%,2544,4.08%
45057,South Carolina,Lancaster County,79089,38869,40220,28749,29859,26997,28351,55348,23741,No,30.02%,18627,24%,3755,4.75%
45059,South Carolina,Laurens County,66223,32223,34000,23508,24323,22208,23241,45449,20774,No,31.37%,17050,26%,2868,4.33%
45061,South Carolina,Lee County,18654,9709,8945,3408,3052,3234,2958,6192,12462,Yes,66.81%,11912,64%,387,2.07%
45063,South Carolina,Lexington County,270406,131856,138550,107831,111887,100532,106105,206637,63769,No,23.58%,40279,15%,15392,5.69%
45065,South Carolina,McCormick County,9943,5426,4517,2600,2249,2556,2226,4782,5161,Yes,51.91%,4937,50%,101,1.02%
45067,South Carolina,Marion County,32457,14912,17545,6483,6991,6123,6751,12874,19583,Yes,60.34%,18205,56%,890,2.74%
45069,South Carolina,Marlboro County,28145,14906,13239,6295,5614,5771,5538,11309,16836,Yes,59.82%,14340,51%,831,2.95%
45071,South Carolina,Newberry County,37576,18382,19194,12138,12599,11002,11641,22643,14933,No,39.74%,11771,31%,2841,7.56%
45073,South Carolina,Oconee County,74627,36857,37770,33152,33799,31473,32377,63850,10777,No,14.44%,5780,8%,3460,4.64%
45075,South Carolina,Orangeburg County,91476,43014,48462,15638,16392,14987,15866,30853,60623,Yes,66.27%,56982,62%,1850,2.02%
45077,South Carolina,Pickens County,119670,59639,60031,53423,53999,51471,52428,103899,15771,No,13.18%,8199,7%,3922,3.28%
45079,South Carolina,Richland County,393830,191428,202402,95506,94578,87590,88163,175753,218077,Yes,55.37%,184282,47%,19651,4.99%
45081,South Carolina,Saluda County,19893,10036,9857,7138,6773,5698,5863,11561,8332,No,41.88%,5230,26%,2943,14.79%
45083,South Carolina,Spartanburg County,288745,139965,148780,106045,110193,97645,103123,200768,87977,No,30.47%,60423,21%,17731,6.14%
45085,South Carolina,Sumter County,108052,52036,56016,26733,26620,25107,25352,50459,57593,Yes,53.30%,50837,47%,3868,3.58%
45087,South Carolina,Union County,28252,13422,14830,8986,9845,8877,9746,18623,9629,No,34.08%,8879,31%,308,1.09%
45089,South Carolina,Williamsburg County,33620,16345,17275,5617,5441,5188,5372,10560,23060,Yes,68.59%,22052,66%,696,2.07%
45091,South Carolina,York County,234635,113091,121544,87360,91708,82486,87096,169582,65053,No,27.73%,45383,19%,11119,4.74%
46003,South Dakota,Aurora County,2742,1415,1327,1350,1289,1284,1244,2528,214,No,7.80%,16,1%,118,4.30%
46005,South Dakota,Beadle County,17753,8961,8792,8036,8028,7357,7482,14839,2914,No,16.41%,268,2%,1443,8.13%
46007,South Dakota,Bennett County,3436,1688,1748,595,566,574,553,1127,2309,Yes,67.20%,10,0%,98,2.85%
46009,South Dakota,Bon Homme County,7029,4063,2966,3446,2863,3363,2837,6200,829,No,11.79%,86,1%,143,2.03%
46011,South Dakota,Brookings County,32629,16729,15900,15534,14948,15207,14667,29874,2755,No,8.44%,405,1%,722,2.21%
46013,South Dakota,Brown County,37331,18274,19057,16988,17671,16667,17433,34100,3231,No,8.66%,408,1%,686,1.84%
46015,South Dakota,Brule County,5293,2590,2703,2316,2352,2280,2322,4602,691,No,13.05%,26,0%,95,1.79%
46017,South Dakota,Buffalo County,2020,999,1021,176,172,175,172,347,1673,Yes,82.82%,9,0%,48,2.38%
46019,South Dakota,Butte County,10228,5132,5096,4865,4820,4734,4706,9440,788,No,7.70%,56,1%,305,2.98%
46021,South Dakota,Campbell County,1396,727,669,718,653,716,644,1360,36,No,2.58%,5,0%,14,1.00%
46023,South Dakota,Charles Mix County,9216,4562,4654,2967,2983,2939,2943,5882,3334,No,36.18%,33,0%,202,2.19%
46025,South Dakota,Clark County,3585,1823,1762,1793,1739,1762,1708,3470,115,No,3.21%,16,0%,70,1.95%
46027,South Dakota,Clay County,14131,6932,7199,6302,6544,6163,6419,12582,1549,No,10.96%,257,2%,342,2.42%
46029,South Dakota,Codington County,27606,13829,13777,13160,13148,12960,12969,25929,1677,No,6.07%,203,1%,471,1.71%
46031,South Dakota,Corson County,4077,2085,1992,670,592,657,586,1243,2834,Yes,69.51%,9,0%,132,3.24%
46033,South Dakota,Custer County,8339,4200,4139,3936,3870,3844,3794,7638,701,No,8.41%,46,1%,199,2.39%
46035,South Dakota,Davison County,19769,9842,9927,9268,9378,9087,9238,18325,1444,No,7.30%,172,1%,396,2.00%
46037,South Dakota,Day County,5613,2842,2771,2516,2457,2475,2432,4907,706,No,12.58%,29,1%,87,1.55%
46039,South Dakota,Deuel County,4380,2269,2111,2218,2064,2156,2015,4171,209,No,4.77%,40,1%,114,2.60%
46041,South Dakota,Dewey County,5538,2704,2834,608,617,591,611,1202,4336,Yes,78.30%,10,0%,121,2.18%
46043,South Dakota,Douglas County,2970,1492,1478,1436,1421,1422,1411,2833,137,No,4.61%,12,0%,39,1.31%
46045,South Dakota,Edmunds County,4026,2021,2005,1979,1970,1950,1940,3890,136,No,3.38%,8,0%,63,1.56%
46047,South Dakota,Fall River County,6971,3554,3417,3153,3035,3080,2956,6036,935,No,13.41%,77,1%,201,2.88%
46049,South Dakota,Faulk County,2377,1201,1176,1183,1160,1174,1152,2326,51,No,2.15%,5,0%,17,0.72%
46051,South Dakota,Grant County,7259,3692,3567,3606,3467,3507,3401,6908,351,No,4.84%,27,0%,185,2.55%
46053,South Dakota,Gregory County,4265,2151,2114,1944,1879,1926,1866,3792,473,No,11.09%,12,0%,53,1.24%
46055,South Dakota,Haakon County,1939,979,960,908,900,901,895,1796,143,No,7.37%,15,1%,15,0.77%
46057,South Dakota,Hamlin County,5918,2974,2944,2916,2894,2835,2837,5672,246,No,4.16%,32,1%,147,2.48%
46059,South Dakota,Hand County,3388,1694,1694,1672,1660,1658,1648,3306,82,No,2.42%,3,0%,28,0.83%
46061,South Dakota,Hanson County,3377,1721,1656,1693,1625,1687,1613,3300,77,No,2.28%,8,0%,21,0.62%
46063,South Dakota,Harding County,1316,699,617,670,597,657,590,1247,69,No,5.24%,5,0%,25,1.90%
46065,South Dakota,Hughes County,17450,8504,8946,7323,7548,7159,7409,14568,2882,No,16.52%,251,1%,472,2.70%
46067,South Dakota,Hutchinson County,7187,3528,3659,3436,3553,3379,3505,6884,303,No,4.22%,46,1%,124,1.73%
46069,South Dakota,Hyde County,1437,735,702,652,631,648,626,1274,163,No,11.34%,6,0%,18,1.25%
46071,South Dakota,Jackson County,3191,1632,1559,719,649,710,645,1355,1836,Yes,57.54%,17,1%,57,1.79%
46073,South Dakota,Jerauld County,2047,1015,1032,1002,1009,949,960,1909,138,No,6.74%,4,0%,105,5.13%
46075,South Dakota,Jones County,1013,495,518,462,483,454,474,928,85,No,8.39%,4,0%,18,1.78%
46077,South Dakota,Kingsbury County,5220,2664,2556,2606,2477,2536,2435,4971,249,No,4.77%,24,0%,122,2.34%
46079,South Dakota,Lake County,11771,6042,5729,5811,5520,5689,5433,11122,649,No,5.51%,106,1%,251,2.13%
46081,South Dakota,Lawrence County,24397,12141,12256,11409,11554,11072,11257,22329,2068,No,8.48%,209,1%,749,3.07%
46083,South Dakota,Lincoln County,48296,23922,24374,22877,23393,22504,23059,45563,2733,No,5.66%,479,1%,792,1.64%
46085,South Dakota,Lyman County,3789,1987,1802,1156,1031,1151,1024,2175,1614,No,42.60%,12,0%,47,1.24%
46087,South Dakota,McCook County,5610,2821,2789,2764,2734,2689,2691,5380,230,No,4.10%,21,0%,134,2.39%
46089,South Dakota,McPherson County,2439,1202,1237,1189,1210,1180,1196,2376,63,No,2.58%,5,0%,24,0.98%
46091,South Dakota,Marshall County,4671,2535,2136,2210,1904,2058,1861,3919,752,No,16.10%,41,1%,317,6.79%
46093,South Dakota,Meade County,26052,13502,12550,12359,11526,11891,11187,23078,2974,No,11.42%,468,2%,986,3.78%
46095,South Dakota,Mellette County,2101,1092,1009,439,432,429,423,852,1249,Yes,59.45%,3,0%,34,1.62%
46097,South Dakota,Miner County,2326,1187,1139,1160,1122,1149,1103,2252,74,No,3.18%,8,0%,30,1.29%
46099,South Dakota,Minnehaha County,175037,87464,87573,77349,78569,73966,75577,149543,25494,No,14.56%,7411,4%,7662,4.38%
46101,South Dakota,Moody County,6446,3238,3208,2680,2608,2619,2565,5184,1262,No,19.58%,54,1%,136,2.11%
46103,South Dakota,Pennington County,104347,52203,52144,43963,43751,42338,42251,84589,19758,No,18.93%,1590,2%,4450,4.26%
46105,South Dakota,Perkins County,3037,1546,1491,1492,1447,1474,1440,2914,123,No,4.05%,10,0%,29,0.95%
46107,South Dakota,Potter County,2359,1148,1211,1120,1173,1105,1162,2267,92,No,3.90%,9,0%,30,1.27%
46109,South Dakota,Roberts County,10303,5162,5141,3191,3037,3153,3009,6162,4141,No,40.19%,24,0%,162,1.57%
46111,South Dakota,Sanborn County,2324,1209,1115,1177,1090,1158,1072,2230,94,No,4.04%,2,0%,43,1.85%
46113,South Dakota,Shannon County,14059,6832,7227,357,395,321,327,648,13411,Yes,95.39%,46,0%,424,3.02%
46115,South Dakota,Spink County,6611,3337,3274,3246,3182,3191,3146,6337,274,No,4.14%,32,0%,98,1.48%
46117,South Dakota,Stanley County,2969,1524,1445,1366,1275,1346,1253,2599,370,No,12.46%,18,1%,45,1.52%
46119,South Dakota,Sully County,1427,775,652,735,629,729,623,1352,75,No,5.26%,10,1%,15,1.05%
46121,South Dakota,Todd County,9942,4890,5052,533,516,517,491,1008,8934,Yes,89.86%,26,0%,291,2.93%
46123,South Dakota,Tripp County,5485,2698,2787,2252,2325,2240,2303,4543,942,No,17.17%,19,0%,74,1.35%
46125,South Dakota,Turner County,8308,4177,4131,4070,4032,4014,3984,7998,310,No,3.73%,39,0%,141,1.70%
46127,South Dakota,Union County,14855,7481,7374,7146,7065,6965,6871,13836,1019,No,6.86%,158,1%,419,2.82%
46129,South Dakota,Walworth County,5459,2684,2775,2223,2287,2200,2269,4469,990,No,18.14%,20,0%,58,1.06%
46135,South Dakota,Yankton County,22603,11688,10915,10725,10315,10363,10130,20493,2110,No,9.34%,449,2%,666,2.95%
46137,South Dakota,Ziebach County,2869,1412,1457,381,316,375,314,689,2180,Yes,75.98%,10,0%,92,3.21%
47001,Tennessee,Anderson County,75416,36468,38948,33686,35998,32842,35226,68068,7348,No,9.74%,3123,4%,1870,2.48%
47003,Tennessee,Bedford County,45573,22569,23004,19861,20321,17483,18235,35718,9855,No,21.62%,3769,8%,5176,11.36%
47005,Tennessee,Benton County,16361,8067,8294,7676,7903,7505,7750,15255,1106,No,6.76%,408,2%,360,2.20%
47007,Tennessee,Bledsoe County,12792,6929,5863,6361,5679,6221,5578,11799,993,No,7.76%,512,4%,269,2.10%
47009,Tennessee,Blount County,124177,60123,64054,56627,60545,54912,59075,113987,10190,No,8.21%,3636,3%,3634,2.93%
47011,Tennessee,Bradley County,101134,49276,51858,45298,47913,42978,45921,88899,12235,No,12.10%,4632,5%,5131,5.07%
47013,Tennessee,Campbell County,40420,19727,20693,19305,20256,19060,20051,39111,1309,No,3.24%,160,0%,511,1.26%
47015,Tennessee,Cannon County,13811,6833,6978,6591,6738,6485,6643,13128,683,No,4.95%,218,2%,215,1.56%
47017,Tennessee,Carroll County,28390,13741,14649,11933,12816,11660,12565,24225,4165,No,14.67%,2960,10%,625,2.20%
47019,Tennessee,Carter County,57355,28070,29285,27131,28428,26669,28036,54705,2650,No,4.62%,828,1%,961,1.68%
47021,Tennessee,Cheatham County,39271,19604,19667,18859,18927,18366,18525,36891,2380,No,6.06%,656,2%,1022,2.60%
47023,Tennessee,Chester County,17171,8238,8933,7277,7868,7089,7691,14780,2391,No,13.92%,1597,9%,427,2.49%
47025,Tennessee,Claiborne County,31736,15498,16238,15036,15730,14919,15594,30513,1223,No,3.85%,321,1%,287,0.90%
47027,Tennessee,Clay County,7840,3860,3980,3741,3847,3672,3807,7479,361,No,4.60%,123,2%,137,1.75%
47029,Tennessee,Cocke County,35571,17231,18340,16443,17545,16131,17296,33427,2144,No,6.03%,718,2%,715,2.01%
47031,Tennessee,Coffee County,53222,25868,27354,23996,25535,23022,24681,47703,5519,No,10.37%,1950,4%,2087,3.92%
47033,Tennessee,Crockett County,14623,6996,7627,5876,6390,5274,5828,11102,3521,No,24.08%,1988,14%,1368,9.36%
47035,Tennessee,Cumberland County,57029,27863,29166,27167,28453,26483,27822,54305,2724,No,4.78%,296,1%,1519,2.66%
47037,Tennessee,Davidson County,648295,313665,334630,209835,216812,179099,191288,370387,277908,No,42.87%,182391,28%,64032,9.88%
47039,Tennessee,Decatur County,11673,5754,5919,5447,5648,5254,5533,10787,886,No,7.59%,360,3%,335,2.87%
47041,Tennessee,DeKalb County,18901,9409,9492,9038,9155,8373,8670,17043,1858,No,9.83%,361,2%,1316,6.96%
47043,Tennessee,Dickson County,50381,24750,25631,22940,23866,22185,23250,45435,4946,No,9.82%,2162,4%,1566,3.11%
47045,Tennessee,Dyer County,38255,18481,19774,15408,16254,14934,15833,30767,7488,No,19.57%,5637,15%,1075,2.81%
47047,Tennessee,Fayette County,38659,19145,19514,13682,13499,13231,13114,26345,12314,No,31.85%,10796,28%,953,2.47%
47049,Tennessee,Fentress County,17940,8810,9130,8666,8967,8562,8881,17443,497,No,2.77%,57,0%,220,1.23%
47051,Tennessee,Franklin County,40772,19848,20924,18289,19176,17788,18727,36515,4257,No,10.44%,2117,5%,1063,2.61%
47053,Tennessee,Gibson County,49626,23626,26000,18993,20504,18466,20077,38543,11083,No,22.33%,9230,19%,1105,2.23%
47055,Tennessee,Giles County,29072,14178,14894,12368,12942,12111,12742,24853,4219,No,14.51%,2963,10%,508,1.75%
47057,Tennessee,Grainger County,22706,11361,11345,11117,11122,10845,10890,21735,971,No,4.28%,143,1%,555,2.44%
47059,Tennessee,Greene County,68819,33791,35028,32370,33667,31495,32883,64378,4441,No,6.45%,1480,2%,1834,2.66%
47061,Tennessee,Grundy County,13650,6736,6914,6576,6749,6497,6687,13184,466,No,3.41%,72,1%,147,1.08%
47063,Tennessee,Hamblen County,62746,30608,32138,28069,29613,24765,26992,51757,10989,No,17.51%,2827,5%,6852,10.92%
47065,Tennessee,Hamilton County,345545,166535,179010,127152,134343,119848,128149,247997,97548,No,28.23%,69446,20%,16504,4.78%
47067,Tennessee,Hancock County,6720,3315,3405,3253,3335,3241,3324,6565,155,No,2.31%,23,0%,23,0.34%
47069,Tennessee,Hardeman County,26533,14455,12078,8024,6932,7855,6820,14675,11858,No,44.69%,11055,42%,387,1.46%
47071,Tennessee,Hardin County,25950,12597,13353,11858,12560,11620,12359,23979,1971,No,7.60%,948,4%,502,1.93%
47073,Tennessee,Hawkins County,56587,27751,28836,26848,27871,26500,27558,54058,2529,No,4.47%,808,1%,748,1.32%
47075,Tennessee,Haywood County,18240,8583,9657,4306,4550,3970,4277,8247,9993,Yes,54.79%,9140,50%,738,4.05%
47077,Tennessee,Henderson County,28023,13513,14510,12134,13058,11844,12827,24671,3352,No,11.96%,2177,8%,612,2.18%
47079,Tennessee,Henry County,32341,15644,16697,13979,14972,13670,14724,28394,3947,No,12.20%,2628,8%,648,2.00%
47081,Tennessee,Hickman County,24170,12695,11475,11532,10947,11288,10760,22048,2122,No,8.78%,1180,5%,491,2.03%
47083,Tennessee,Houston County,8413,4190,4223,3961,4005,3874,3940,7814,599,No,7.12%,240,3%,164,1.95%
47085,Tennessee,Humphreys County,18275,9051,9224,8598,8807,8437,8664,17101,1174,No,6.42%,498,3%,375,2.05%
47087,Tennessee,Jackson County,11441,5722,5719,5598,5602,5516,5512,11028,413,No,3.61%,48,0%,186,1.63%
47089,Tennessee,Jefferson County,52191,25682,26509,24437,25411,23545,24719,48264,3927,No,7.52%,1209,2%,1773,3.40%
47091,Tennessee,Johnson County,18095,9707,8388,9209,8223,9056,8108,17164,931,No,5.15%,405,2%,287,1.59%
47093,Tennessee,Knox County,441311,214737,226574,186088,195677,178624,189122,367746,73565,No,16.67%,40037,9%,16631,3.77%
47095,Tennessee,Lake County,7690,4918,2772,3236,2117,3157,2082,5239,2451,No,31.87%,2176,28%,144,1.87%
47097,Tennessee,Lauderdale County,27718,14527,13191,8945,8444,8670,8245,16915,10803,No,38.97%,9713,35%,651,2.35%
47099,Tennessee,Lawrence County,42086,20579,21507,19705,20738,19348,20451,39799,2287,No,5.43%,684,2%,736,1.75%
47101,Tennessee,Lewis County,11896,5861,6035,5599,5801,5485,5697,11182,714,No,6.00%,244,2%,230,1.93%
47103,Tennessee,Lincoln County,33503,16396,17107,14795,15377,14350,15052,29402,4101,No,12.24%,2350,7%,953,2.84%
47105,Tennessee,Loudon County,49793,24369,25424,23386,24494,21534,22940,44474,5319,No,10.68%,717,1%,3722,7.47%
47107,Tennessee,McMinn County,52416,25500,26916,23637,25073,22936,24441,47377,5039,No,9.61%,2150,4%,1548,2.95%
47109,Tennessee,McNairy County,26180,12818,13362,11798,12315,11588,12150,23738,2442,No,9.33%,1574,6%,443,1.69%
47111,Tennessee,Macon County,22498,11051,11447,10727,11203,10229,10809,21038,1460,No,6.49%,128,1%,1058,4.70%
47113,Tennessee,Madison County,98656,46826,51830,28847,30645,27259,29301,56560,42096,No,42.67%,36475,37%,3467,3.51%
47115,Tennessee,Marion County,28291,13879,14412,13041,13532,12861,13352,26213,2078,No,7.35%,1104,4%,397,1.40%
47117,Tennessee,Marshall County,30883,15160,15723,13749,14264,13072,13669,26741,4142,No,13.41%,2063,7%,1438,4.66%
47119,Tennessee,Maury County,81990,39592,42398,33649,35650,31703,33940,65643,16347,No,19.94%,10219,12%,4128,5.03%
47121,Tennessee,Meigs County,11698,5812,5886,5588,5675,5516,5606,11122,576,No,4.92%,179,2%,196,1.68%
47123,Tennessee,Monroe County,45133,22336,22797,21175,21652,20468,20989,41457,3676,No,8.14%,1040,2%,1598,3.54%
47125,Tennessee,Montgomery County,184468,91630,92838,67697,67158,61028,61181,122209,62259,No,33.75%,36027,20%,16328,8.85%
47127,Tennessee,Moore County,6339,3104,3235,2968,3108,2931,3071,6002,337,No,5.32%,152,2%,89,1.40%
47129,Tennessee,Morgan County,21931,12074,9857,11077,9627,10968,9533,20501,1430,No,6.52%,830,4%,234,1.07%
47131,Tennessee,Obion County,31340,15047,16293,13190,14255,12692,13822,26514,4826,No,15.40%,3350,11%,1044,3.33%
47133,Tennessee,Overton County,22190,10907,11283,10657,11040,10515,10939,21454,736,No,3.32%,124,1%,265,1.19%
47135,Tennessee,Perry County,7860,3960,3900,3758,3726,3681,3668,7349,511,No,6.50%,168,2%,152,1.93%
47137,Tennessee,Pickett County,5100,2563,2537,2534,2505,2483,2473,4956,144,No,2.82%,11,0%,86,1.69%
47139,Tennessee,Polk County,16686,8246,8440,8039,8221,7917,8114,16031,655,No,3.93%,95,1%,278,1.67%
47141,Tennessee,Putnam County,73229,36224,37005,33967,35022,32133,33441,65574,7655,No,10.45%,1629,2%,4037,5.51%
47143,Tennessee,Rhea County,32247,15884,16363,15106,15610,14467,15116,29583,2664,No,8.26%,696,2%,1290,4.00%
47145,Tennessee,Roane County,53469,26298,27171,24887,25727,24511,25373,49884,3585,No,6.70%,1430,3%,827,1.55%
47147,Tennessee,Robertson County,66931,32911,34020,29626,30455,27627,28824,56451,10480,No,15.66%,5179,8%,4052,6.05%
47149,Tennessee,Rutherford County,274454,135418,139036,110188,112027,101222,104254,205476,68978,No,25.13%,35894,13%,19291,7.03%
47151,Tennessee,Scott County,22173,10895,11278,10709,11094,10645,11039,21684,489,No,2.21%,52,0%,144,0.65%
47153,Tennessee,Sequatchie County,14423,7072,7351,6873,7178,6616,7010,13626,797,No,5.53%,76,1%,487,3.38%
47155,Tennessee,Sevier County,92512,45483,47029,43634,45311,41059,43319,84378,8134,No,8.79%,997,1%,5092,5.50%
47157,Tennessee,Shelby County,940764,449153,491611,199783,203964,173631,182983,356614,584150,Yes,62.09%,496686,53%,55723,5.92%
47159,Tennessee,Smith County,19102,9457,9645,9060,9216,8815,9033,17848,1254,No,6.56%,417,2%,475,2.49%
47161,Tennessee,Stewart County,13297,6642,6655,6286,6283,6141,6152,12293,1004,No,7.55%,275,2%,304,2.29%
47163,Tennessee,Sullivan County,156786,75884,80902,72189,77437,71037,76455,147492,9294,No,5.93%,3608,2%,2539,1.62%
47165,Tennessee,Sumner County,166123,80994,85129,73078,76565,69966,73699,143665,22458,No,13.52%,11202,7%,6736,4.05%
47167,Tennessee,Tipton County,61705,30370,31335,23924,24342,23290,23823,47113,14592,No,23.65%,11658,19%,1444,2.34%
47169,Tennessee,Trousdale County,7795,3853,3942,3382,3479,3284,3402,6686,1109,No,14.23%,744,10%,209,2.68%
47171,Tennessee,Unicoi County,18235,8942,9293,8764,9116,8358,8788,17146,1089,No,5.97%,71,0%,766,4.20%
47173,Tennessee,Union County,19127,9536,9591,9335,9372,9210,9282,18492,635,No,3.32%,41,0%,265,1.39%
47175,Tennessee,Van Buren County,5628,2782,2846,2739,2774,2709,2751,5460,168,No,2.99%,32,1%,60,1.07%
47177,Tennessee,Warren County,39839,19679,20160,18511,19012,16787,17777,34564,5275,No,13.24%,1356,3%,3316,8.32%
47179,Tennessee,Washington County,125094,61193,63901,56435,59382,54722,57825,112547,12547,No,10.03%,5170,4%,3828,3.06%
47181,Tennessee,Wayne County,16996,9383,7613,8282,7423,8107,7335,15442,1554,No,9.14%,1023,6%,302,1.78%
47183,Tennessee,Weakley County,34793,17019,17774,15166,15821,14842,15514,30356,4437,No,12.75%,2801,8%,741,2.13%
47185,Tennessee,White County,26082,12766,13316,12203,12804,11991,12606,24597,1485,No,5.69%,498,2%,487,1.87%
47187,Tennessee,Williamson County,192911,94238,98673,85361,89201,81078,85119,166197,26714,No,13.85%,8677,4%,9041,4.69%
47189,Tennessee,Wilson County,118961,58232,60729,52535,54603,50588,52856,103444,15517,No,13.04%,7860,7%,4147,3.49%
48001,Texas,Anderson County,58190,35504,22686,25289,18536,19446,15741,35187,23003,No,39.53%,12634,22%,9613,16.52%
48003,Texas,Andrews County,16117,8120,7997,7652,7575,3525,3669,7194,8923,Yes,55.36%,352,2%,8336,51.72%
48005,Texas,Angelina County,87597,42830,44767,35196,36229,26489,28101,54590,33007,No,37.68%,13560,15%,18091,20.65%
48007,Texas,Aransas County,23818,11799,12019,10993,11232,8103,8445,16548,7270,No,30.52%,407,2%,6062,25.45%
48009,Texas,Archer County,8735,4379,4356,4233,4204,3890,3906,7796,939,No,10.75%,61,1%,723,8.28%
48011,Texas,Armstrong County,1944,959,985,929,948,849,874,1723,221,No,11.37%,25,1%,161,8.28%
48013,Texas,Atascosa County,46446,23008,23438,22053,22518,8043,8406,16449,29997,Yes,64.58%,556,1%,29035,62.51%
48015,Texas,Austin County,28618,14218,14400,12500,12584,9027,9393,18420,10198,No,35.63%,2749,10%,7108,24.84%
48017,Texas,Bailey County,7130,3684,3446,3470,3267,1307,1331,2638,4492,Yes,63.00%,104,1%,4347,60.97%
48019,Texas,Bandera County,20537,10205,10332,9855,9978,8146,8306,16452,4085,No,19.89%,129,1%,3555,17.31%
48021,Texas,Bastrop County,74763,38189,36574,33192,31980,20855,21108,41963,32800,No,43.87%,6009,8%,25285,33.82%
48023,Texas,Baylor County,3623,1753,1870,1662,1774,1470,1535,3005,618,No,17.06%,103,3%,471,13.00%
48025,Texas,Bee County,32527,19505,13022,16598,12317,6687,4254,10941,21586,Yes,66.36%,2764,8%,18494,56.86%
48027,Texas,Bell County,323037,161113,161924,111383,109658,80335,79812,160147,162890,Yes,50.42%,72316,22%,73357,22.71%
48029,Texas,Bexar County,1785704,878002,907702,752712,776554,264642,266786,531428,1254276,Yes,70.24%,145088,8%,1054725,59.06%
48031,Texas,Blanco County,10655,5388,5267,5107,5058,4114,4203,8317,2338,No,21.94%,119,1%,2035,19.10%
48033,Texas,Borden County,616,321,295,312,281,265,241,506,110,No,17.86%,2,0%,99,16.07%
48035,Texas,Bosque County,18125,8980,9145,8531,8750,7047,7438,14485,3640,No,20.08%,356,2%,2978,16.43%
48037,Texas,Bowie County,93148,47075,46073,33625,33023,30113,31139,61252,31896,No,34.24%,22752,24%,6419,6.89%
48039,Texas,Brazoria County,324769,164960,159809,129547,125664,84204,83435,167639,157130,No,48.38%,42135,13%,92718,28.55%
48041,Texas,Brazos County,200665,101773,98892,82325,79838,58860,57990,116850,83815,No,41.77%,22560,11%,48345,24.09%
48043,Texas,Brewster County,9316,4674,4642,4389,4377,2463,2439,4902,4414,No,47.38%,127,1%,4085,43.85%
48045,Texas,Briscoe County,1561,780,781,746,737,526,529,1055,506,No,32.42%,44,3%,441,28.25%
48047,Texas,Brooks County,7161,3543,3618,3468,3534,290,313,603,6558,Yes,91.58%,64,1%,6490,90.63%
48049,Texas,Brown County,37825,18776,19049,17439,17891,13659,14270,27929,9896,No,26.16%,1379,4%,7752,20.49%
48051,Texas,Burleson County,17291,8577,8714,7297,7349,5634,5845,11479,5812,No,33.61%,2197,13%,3372,19.50%
48053,Texas,Burnet County,43448,21329,22119,20261,21006,15852,16890,32742,10706,No,24.64%,889,2%,9030,20.78%
48055,Texas,Caldwell County,38734,19545,19189,17370,16970,8331,8234,16565,22169,Yes,57.23%,2786,7%,18807,48.55%
48057,Texas,Calhoun County,21609,11046,10563,9944,9596,4882,4738,9620,11989,Yes,55.48%,647,3%,10259,47.48%
48059,Texas,Callahan County,13517,6646,6871,6367,6561,5798,6049,11847,1670,No,12.35%,196,1%,1165,8.62%
48061,Texas,Cameron County,415557,200455,215102,194841,209687,21624,21114,42738,372819,Yes,89.72%,3239,1%,367254,88.38%
48063,Texas,Camp County,12449,6140,6309,4857,4956,3523,3765,7288,5161,No,41.46%,2111,17%,2768,22.23%
48065,Texas,Carson County,6157,3045,3112,2927,2999,2649,2727,5376,781,No,12.68%,44,1%,576,9.36%
48067,Texas,Cass County,30166,14648,15518,11892,12349,11332,11857,23189,6977,No,23.13%,5226,17%,1197,3.97%
48069,Texas,Castro County,8164,4225,3939,4010,3720,1467,1463,2930,5234,Yes,64.11%,199,2%,4996,61.20%
48071,Texas,Chambers County,36196,18212,17984,16007,15815,12507,12626,25133,11063,No,30.56%,3035,8%,7332,20.26%
48073,Texas,Cherokee County,51206,26078,25128,20954,20558,15521,16182,31703,19503,No,38.09%,7675,15%,11019,21.52%
48075,Texas,Childress County,7029,4107,2922,3440,2691,2150,2064,4214,2815,No,40.05%,709,10%,1979,28.15%
48077,Texas,Clay County,10535,5246,5289,5018,5058,4790,4831,9621,914,No,8.68%,79,1%,537,5.10%
48079,Texas,Cochran County,3046,1486,1560,1369,1425,578,596,1174,1872,Yes,61.46%,139,5%,1723,56.57%
48081,Texas,Coke County,3231,1570,1661,1499,1594,1184,1297,2481,750,No,23.21%,23,1%,668,20.67%
48083,Texas,Coleman County,8675,4316,4359,4051,4098,3388,3409,6797,1878,No,21.65%,240,3%,1482,17.08%
48085,Texas,Collin County,834642,410667,423975,312331,318788,253997,261944,515941,318701,No,38.18%,77106,9%,125485,15.03%
48087,Texas,Collingsworth County,3036,1491,1545,1356,1381,930,943,1873,1163,No,38.31%,170,6%,951,31.32%
48089,Texas,Colorado County,20696,10293,10403,8665,8655,5991,6211,12202,8494,No,41.04%,2793,13%,5602,27.07%
48091,Texas,Comal County,114384,56243,58141,53285,54999,39437,40777,80214,34170,No,29.87%,2307,2%,29555,25.84%
48093,Texas,Comanche County,13765,6807,6958,6609,6719,4765,5103,9868,3897,No,28.31%,105,1%,3642,26.46%
48095,Texas,Concho County,4010,2752,1258,2602,1212,881,845,1726,2284,Yes,56.96%,99,2%,2171,54.14%
48097,Texas,Cooke County,38688,19136,19552,17757,18158,14646,15340,29986,8702,No,22.49%,1232,3%,6380,16.49%
48099,Texas,Coryell County,77231,38360,38871,28969,28944,23355,23673,47028,30203,No,39.11%,13008,17%,13099,16.96%
48101,Texas,Cottle County,1486,713,773,629,688,474,524,998,488,No,32.84%,147,10%,334,22.48%
48103,Texas,Crane County,4562,2249,2313,2082,2169,817,912,1729,2833,Yes,62.10%,167,4%,2615,57.32%
48105,Texas,Crockett County,3743,1832,1911,1733,1834,625,675,1300,2443,Yes,65.27%,59,2%,2373,63.40%
48107,Texas,Crosby County,6126,2984,3142,2766,2926,1211,1336,2547,3579,Yes,58.42%,266,4%,3273,53.43%
48109,Texas,Culberson County,2290,1120,1170,1042,1100,290,243,533,1757,Yes,76.72%,18,1%,1681,73.41%
48111,Texas,Dallam County,6996,3642,3354,3414,3177,1929,1859,3788,3208,No,45.85%,120,2%,2938,42.00%
48113,Texas,Dallas County,2453843,1214995,1238848,851687,834278,387658,403052,790710,1663133,Yes,67.78%,561479,23%,954070,38.88%
48115,Texas,Dawson County,13640,7789,5851,6804,5424,2872,2334,5206,8434,Yes,61.83%,1008,7%,7352,53.90%
48117,Texas,Deaf Smith County,19360,9623,9737,9160,9237,2670,2886,5556,13804,Yes,71.30%,357,2%,13369,69.05%
48119,Texas,Delta County,5329,2647,2682,2321,2315,2144,2191,4335,994,No,18.65%,426,8%,350,6.57%
48121,Texas,Denton County,707304,348528,358776,282088,286660,220442,226631,447073,260231,No,36.79%,64865,9%,131954,18.66%
48123,Texas,DeWitt County,20465,10653,9812,9270,8750,5801,5823,11624,8841,No,43.20%,1954,10%,6812,33.29%
48125,Texas,Dickens County,2323,1339,984,1185,924,784,712,1496,827,No,35.60%,113,5%,675,29.06%
48127,Texas,Dimmit County,10461,5100,5361,4910,5171,689,636,1325,9136,Yes,87.33%,148,1%,8918,85.25%
48129,Texas,Donley County,3598,1766,1832,1648,1684,1478,1529,3007,591,No,16.43%,178,5%,335,9.31%
48131,Texas,Duval County,11717,6107,5610,5885,5493,690,526,1216,10501,Yes,89.62%,167,1%,10319,88.07%
48133,Texas,Eastland County,18421,9008,9413,8513,9019,7141,7734,14875,3546,No,19.25%,418,2%,2814,15.28%
48135,Texas,Ector County,144325,72044,72281,65890,66222,27526,28336,55862,88463,Yes,61.29%,6881,5%,79476,55.07%
48137,Texas,Edwards County,1968,993,975,950,937,426,448,874,1094,Yes,55.59%,17,1%,1062,53.96%
48139,Texas,Ellis County,153969,76025,77944,66807,68079,48626,50919,99545,54424,No,35.35%,14332,9%,37415,24.30%
48141,Texas,El Paso County,827398,404217,423181,371253,393650,60729,52260,112989,714409,Yes,86.34%,31917,4%,671452,81.15%
48143,Texas,Erath County,39321,19379,19942,18306,19041,14489,15582,30071,9250,No,23.52%,625,2%,7825,19.90%
48145,Texas,Falls County,17610,8373,9237,6146,6439,4369,4796,9165,8445,No,47.96%,4482,25%,3802,21.59%
48147,Texas,Fannin County,33831,17911,15920,15642,14583,13717,13347,27064,6767,No,20.00%,2350,7%,3445,10.18%
48149,Texas,Fayette County,24695,12127,12568,11056,11363,8814,9235,18049,6646,No,26.91%,1657,7%,4755,19.25%
48151,Texas,Fisher County,3844,1890,1954,1781,1823,1298,1352,2650,1194,No,31.06%,143,4%,1023,26.61%
48153,Texas,Floyd County,6367,3127,3240,2937,3035,1238,1351,2589,3778,Yes,59.34%,259,4%,3501,54.99%
48155,Texas,Foard County,1307,627,680,595,635,485,544,1029,278,No,21.27%,57,4%,206,15.76%
48157,Texas,Fort Bend County,627293,308261,319032,181371,181924,111878,112322,224200,403093,Yes,64.26%,134318,21%,150755,24.03%
48159,Texas,Franklin County,10640,5219,5421,4840,4985,4140,4398,8538,2102,No,19.76%,462,4%,1394,13.10%
48161,Texas,Freestone County,19515,10232,9283,8056,7551,6670,6533,13203,6312,No,32.34%,3209,16%,2848,14.59%
48163,Texas,Frio County,17702,10305,7397,9178,7128,1505,1289,2794,14908,Yes,84.22%,683,4%,13859,78.29%
48165,Texas,Gaines County,18413,9340,9073,8870,8664,5381,5418,10799,7614,No,41.35%,388,2%,7090,38.51%
48167,Texas,Galveston County,300484,148775,151709,120254,120411,87418,88547,175965,124519,No,41.44%,41918,14%,69608,23.17%
48169,Texas,Garza County,6412,4072,2340,3734,2132,1619,1278,2897,3515,Yes,54.82%,448,7%,3054,47.63%
48171,Texas,Gillespie County,25153,12155,12998,11779,12628,9204,10269,19473,5680,No,22.58%,140,1%,5257,20.90%
48173,Texas,Glasscock County,1259,662,597,647,575,431,379,810,449,No,35.66%,20,2%,420,33.36%
48175,Texas,Goliad County,7351,3693,3658,3403,3385,2139,2150,4289,3062,No,41.65%,389,5%,2634,35.83%
48177,Texas,Gonzales County,20045,10108,9937,8991,8845,4234,4456,8690,11355,Yes,56.65%,1559,8%,9775,48.77%
48179,Texas,Gray County,22978,12018,10960,10694,10181,7664,7717,15381,7597,No,33.06%,1199,5%,5868,25.54%
48181,Texas,Grayson County,121935,59444,62491,52718,55356,45935,48936,94871,27064,No,22.20%,7367,6%,14456,11.86%
48183,Texas,Gregg County,122658,60061,62597,45889,46897,35543,38023,73566,49092,No,40.02%,24946,20%,21184,17.27%
48185,Texas,Grimes County,26783,14537,12246,11606,10033,8442,7556,15998,10785,No,40.27%,4428,17%,6000,22.40%
48187,Texas,Guadalupe County,139841,68849,70992,60520,61904,36982,37852,74834,65007,No,46.49%,10257,7%,50702,36.26%
48189,Texas,Hale County,36385,18826,17559,16908,16122,6574,6451,13025,23360,Yes,64.20%,2179,6%,20991,57.69%
48191,Texas,Hall County,3293,1631,1662,1479,1489,949,963,1912,1381,No,41.94%,240,7%,1121,34.04%
48193,Texas,Hamilton County,8307,4100,4207,3920,4061,3522,3685,7207,1100,No,13.24%,78,1%,910,10.95%
48195,Texas,Hansford County,5521,2799,2722,2697,2613,1438,1518,2956,2565,No,46.46%,48,1%,2465,44.65%
48197,Texas,Hardeman County,4082,2049,2033,1849,1851,1433,1461,2894,1188,No,29.10%,245,6%,869,21.29%
48199,Texas,Hardin County,55190,27256,27934,25118,25613,23749,24450,48199,6991,No,12.67%,3272,6%,2751,4.98%
48201,Texas,Harris County,4253700,2120065,2133635,1528045,1489993,681213,688921,1370134,2883566,Yes,67.79%,830893,20%,1764047,41.47%
48203,Texas,Harrison County,67450,32953,34497,24763,25221,21107,21996,43103,24347,No,36.10%,15198,23%,7967,11.81%
48205,Texas,Hartley County,6144,3786,2358,3309,2277,2287,1859,4146,1998,No,32.52%,430,7%,1481,24.10%
48207,Texas,Haskell County,5901,3114,2787,2839,2611,2118,1990,4108,1793,No,30.38%,263,4%,1435,24.32%
48209,Texas,Hays County,168990,84248,84742,76885,77544,48344,48821,97165,71825,No,42.50%,6651,4%,61286,36.27%
48211,Texas,Hemphill County,4080,2072,2008,2002,1932,1344,1388,2732,1348,No,33.04%,32,1%,1243,30.47%
48213,Texas,Henderson County,79094,38691,40403,34886,36645,30554,32552,63106,15988,No,20.21%,5195,7%,9149,11.57%
48215,Texas,Hidalgo County,806552,393930,412622,382302,401436,30349,29946,60295,746257,Yes,92.52%,6594,1%,733012,90.88%
48217,Texas,Hill County,35115,17208,17907,15563,16051,12237,13121,25358,9757,No,27.79%,2537,7%,6681,19.03%
48219,Texas,Hockley County,23072,11314,11758,10504,10923,5530,5844,11374,11698,Yes,50.70%,965,4%,10529,45.64%
48221,Texas,Hood County,52044,25643,26401,24722,25473,21852,22950,44802,7242,No,13.92%,362,1%,5746,11.04%
48223,Texas,Hopkins County,35469,17569,17900,15737,15990,12962,13634,26596,8873,No,25.02%,2547,7%,5596,15.78%
48225,Texas,Houston County,23161,12386,10775,8749,7793,7309,6998,14307,8854,No,38.23%,6088,26%,2449,10.57%
48227,Texas,Howard County,35408,20048,15360,17364,14080,9940,8587,18527,16881,No,47.68%,2470,7%,13891,39.23%
48229,Texas,Hudspeth County,3337,1678,1659,1591,1575,317,284,601,2736,Yes,81.99%,55,2%,2651,79.44%
48231,Texas,Hunt County,87079,43012,44067,37478,38274,31514,32854,64368,22711,No,26.08%,7441,9%,12583,14.45%
48233,Texas,Hutchinson County,21922,10977,10945,10145,10138,7904,8003,15907,6015,No,27.44%,615,3%,4708,21.48%
48235,Texas,Irion County,1573,781,792,749,765,553,569,1122,451,No,28.67%,20,1%,404,25.68%
48237,Texas,Jack County,8983,5020,3963,4593,3810,3792,3288,7080,1903,No,21.18%,371,4%,1406,15.65%
48239,Texas,Jackson County,14255,7066,7189,6377,6461,4298,4480,8778,5477,No,38.42%,1055,7%,4287,30.07%
48241,Texas,Jasper County,35923,17699,18224,14334,14575,13201,13713,26914,9009,No,25.08%,6060,17%,2205,6.14%
48243,Texas,Jeff Davis County,2307,1182,1125,1127,1077,749,716,1465,842,No,36.50%,36,2%,772,33.46%
48245,Texas,Jefferson County,251813,128556,123257,78007,72183,54753,54627,109380,142433,Yes,56.56%,86176,34%,45772,18.18%
48247,Texas,Jim Hogg County,5249,2611,2638,2540,2592,170,154,324,4925,Yes,93.83%,31,1%,4851,92.42%
48249,Texas,Jim Wells County,41754,20671,21083,19967,20463,3990,4047,8037,33717,Yes,80.75%,373,1%,33090,79.25%
48251,Texas,Johnson County,153441,76748,76693,71359,71742,56930,58791,115721,37720,No,24.58%,4652,3%,29070,18.95%
48253,Texas,Jones County,19973,12451,7522,9778,6933,6687,5406,12093,7880,No,39.45%,2611,13%,5171,25.89%
48255,Texas,Karnes County,15233,9085,6148,7578,5854,3251,2744,5995,9238,Yes,60.64%,1504,10%,7698,50.54%
48257,Texas,Kaufman County,106753,52480,54273,45185,46316,35969,37438,73407,33346,No,31.24%,11316,11%,19448,18.22%
48259,Texas,Kendall County,35956,17540,18416,16852,17737,13162,14145,27307,8649,No,24.05%,303,1%,7661,21.31%
48261,Texas,Kenedy County,431,216,215,200,207,37,42,79,352,Yes,81.67%,14,3%,336,77.96%
48263,Texas,Kent County,839,407,432,390,416,321,358,679,160,No,19.07%,10,1%,134,15.97%
48265,Texas,Kerr County,49786,24092,25694,22594,24317,16754,18643,35397,14389,No,28.90%,1049,2%,12405,24.92%
48267,Texas,Kimble County,4560,2274,2286,2201,2226,1623,1724,3347,1213,No,26.60%,25,1%,1115,24.45%
48269,Texas,King County,276,139,137,135,130,110,117,227,49,No,17.75%,0,0%,40,14.49%
48271,Texas,Kinney County,3603,1972,1631,1889,1545,751,712,1463,2140,Yes,59.39%,66,2%,2041,56.65%
48273,Texas,Kleberg County,32025,16333,15692,14718,14367,3811,3337,7148,24877,Yes,77.68%,1397,4%,22702,70.89%
48275,Texas,Knox County,3789,1861,1928,1681,1751,1099,1210,2309,1480,No,39.06%,228,6%,1209,31.91%
48277,Texas,Lamar County,49811,24051,25760,19677,20861,18152,19449,37601,12210,No,24.51%,6820,14%,3403,6.83%
48279,Texas,Lamb County,14008,7000,7008,6420,6422,2816,2993,5809,8199,Yes,58.53%,689,5%,7459,53.25%
48281,Texas,Lampasas County,20107,9901,10206,9044,9242,7338,7627,14965,5142,No,25.57%,750,4%,3649,18.15%
48283,Texas,La Salle County,7109,4177,2932,4081,2836,479,447,926,6183,Yes,86.97%,68,1%,6071,85.40%
48285,Texas,Lavaca County,19468,9532,9936,8657,8985,7076,7486,14562,4906,No,25.20%,1394,7%,3346,17.19%
48287,Texas,Lee County,16601,8384,8217,7158,7122,5314,5421,10735,5866,No,35.34%,1817,11%,3804,22.91%
48289,Texas,Leon County,16803,8389,8414,7585,7509,6441,6505,12946,3857,No,22.95%,1263,8%,2299,13.68%
48291,Texas,Liberty County,76571,37574,38997,32395,33304,25311,26714,52025,24546,No,32.06%,8504,11%,14761,19.28%
48293,Texas,Limestone County,23585,12182,11403,9689,8929,7290,7095,14385,9200,No,39.01%,4251,18%,4654,19.73%
48295,Texas,Lipscomb County,3480,1776,1704,1666,1591,1162,1136,2298,1182,No,33.97%,60,2%,1067,30.66%
48297,Texas,Live Oak County,11664,6308,5356,5624,5191,3437,3260,6697,4967,No,42.58%,550,5%,4282,36.71%
48299,Texas,Llano County,19085,9195,9890,8883,9507,8134,8700,16834,2251,No,11.79%,203,1%,1697,8.89%
48301,Texas,Loving County,71,38,33,36,32,27,23,50,21,No,29.58%,1,1%,18,25.35%
48303,Texas,Lubbock County,285760,141296,144464,123063,126076,78838,82215,161053,124707,No,43.64%,22235,8%,94060,32.92%
48305,Texas,Lynn County,5783,2871,2912,2689,2760,1385,1493,2878,2905,Yes,50.23%,144,2%,2709,46.84%
48307,Texas,McCulloch County,8313,4101,4212,3861,3995,2620,2834,5454,2859,No,34.39%,223,3%,2553,30.71%
48309,Texas,McLennan County,238707,116433,122274,94370,97498,67326,71490,138816,99891,No,41.85%,36124,15%,58200,24.38%
48311,Texas,McMullen County,726,370,356,348,345,218,229,447,279,No,38.43%,7,1%,261,35.95%
48313,Texas,Madison County,13677,7869,5808,5775,4644,4131,3739,7870,5807,No,42.46%,2804,21%,2814,20.57%
48315,Texas,Marion County,10324,5057,5267,3837,3807,3687,3638,7325,2999,No,29.05%,2305,22%,383,3.71%
48317,Texas,Martin County,5017,2555,2462,2425,2348,1317,1287,2604,2413,No,48.10%,107,2%,2262,45.09%
48319,Texas,Mason County,4003,1990,2013,1936,1962,1502,1573,3075,928,No,23.18%,30,1%,863,21.56%
48321,Texas,Matagorda County,36547,18288,18259,15362,15205,8434,8619,17053,19494,Yes,53.34%,4228,12%,14384,39.36%
48323,Texas,Maverick County,55365,27270,28095,26526,27354,951,806,1757,53608,Yes,96.83%,270,0%,52714,95.21%
48325,Texas,Medina County,46765,24120,22645,22386,21707,10728,10660,21388,25377,Yes,54.26%,1238,3%,23594,50.45%
48327,Texas,Menard County,2240,1122,1118,1075,1086,697,717,1414,826,No,36.88%,25,1%,785,35.04%
48329,Texas,Midland County,146645,72687,73958,64868,65865,37062,38188,75250,71395,No,48.69%,10042,7%,58300,39.76%
48331,Texas,Milam County,24157,11894,12263,10329,10632,7568,7934,15502,8655,No,35.83%,2507,10%,5920,24.51%
48333,Texas,Mills County,4828,2362,2466,2284,2399,1897,2007,3904,924,No,19.14%,46,1%,824,17.07%
48335,Texas,Mitchell County,9336,5728,3608,4483,3333,2426,2138,4564,4772,Yes,51.11%,1196,13%,3564,38.17%
48337,Texas,Montague County,19565,9668,9897,9319,9537,8390,8662,17052,2513,No,12.84%,100,1%,1986,10.15%
48339,Texas,Montgomery County,485047,240628,244419,217734,219882,167193,172365,339558,145489,No,29.99%,22439,5%,105014,21.65%
48341,Texas,Moore County,22313,11592,10721,9891,9541,3963,4106,8069,14244,Yes,63.84%,609,3%,11813,52.94%
48343,Texas,Morris County,12787,6154,6633,4586,4849,4069,4379,8448,4339,No,33.93%,2918,23%,1106,8.65%
48345,Texas,Motley County,1202,628,574,597,553,497,470,967,235,No,19.55%,32,3%,200,16.64%
48347,Texas,Nacogdoches County,66034,31673,34361,24984,26262,19206,20933,40139,25895,No,39.21%,12181,18%,12047,18.24%
48349,Texas,Navarro County,47979,23827,24152,19534,19717,13801,14409,28210,19769,No,41.20%,6759,14%,11970,24.95%
48351,Texas,Newton County,14200,7307,6893,5538,5330,5300,5168,10468,3732,No,26.28%,2954,21%,446,3.14%
48353,Texas,Nolan County,14924,7416,7508,6797,6884,4345,4426,8771,6153,No,41.23%,779,5%,5196,34.82%
48355,Texas,Nueces County,347691,170976,176715,156503,161746,55429,55645,111074,236617,Yes,68.05%,15101,4%,213990,61.55%
48357,Texas,Ochiltree County,10728,5467,5261,5250,5056,2457,2594,5051,5677,Yes,52.92%,80,1%,5443,50.74%
48359,Texas,Oldham County,2060,1044,1016,974,937,845,815,1660,400,No,19.42%,81,4%,269,13.06%
48361,Texas,Orange County,82977,41138,41839,36410,36787,33828,34451,68279,14698,No,17.71%,7169,9%,5398,6.51%
48363,Texas,Palo Pinto County,27856,13627,14229,12907,13461,10385,10967,21352,6504,No,23.35%,666,2%,5304,19.04%
48365,Texas,Panola County,24020,11902,12118,9691,9753,8683,8924,17607,6413,No,26.70%,3879,16%,2097,8.73%
48367,Texas,Parker County,119712,60668,59044,57154,56443,50525,50654,101179,18533,No,15.48%,2340,2%,13256,11.07%
48369,Texas,Parmer County,10183,5291,4892,5028,4653,1935,1903,3838,6345,Yes,62.31%,149,1%,6153,60.42%
48371,Texas,Pecos County,15619,8830,6789,8039,6486,2523,1717,4240,11379,Yes,72.85%,632,4%,10572,67.69%
48373,Texas,Polk County,45656,24393,21263,20193,18326,16756,16006,32762,12894,No,28.24%,5234,11%,6273,13.74%
48375,Texas,Potter County,122335,62743,59592,50530,49399,28780,29511,58291,64044,Yes,52.35%,13138,11%,44657,36.50%
48377,Texas,Presidio County,7525,3725,3800,3560,3653,580,525,1105,6420,Yes,85.32%,70,1%,6244,82.98%
48379,Texas,Rains County,10943,5550,5393,5227,5068,4793,4694,9487,1456,No,13.31%,289,3%,885,8.09%
48381,Texas,Randall County,125082,61095,63987,56556,59769,46079,49396,95475,29607,No,23.67%,3504,3%,22315,17.84%
48383,Texas,Reagan County,3475,1830,1645,1712,1541,576,582,1158,2317,Yes,66.68%,100,3%,2206,63.48%
48385,Texas,Real County,3369,1662,1707,1571,1629,1155,1213,2368,1001,No,29.71%,31,1%,889,26.39%
48387,Texas,Red River County,12694,6168,6526,4892,5156,4502,4782,9284,3410,No,26.86%,2230,18%,903,7.11%
48389,Texas,Reeves County,13798,8289,5509,7505,5206,1820,872,2692,11106,Yes,80.49%,749,5%,10241,74.22%
48391,Texas,Refugio County,7259,3617,3642,3232,3310,1570,1619,3189,4070,Yes,56.07%,498,7%,3510,48.35%
48393,Texas,Roberts County,854,419,435,404,420,354,370,724,130,No,15.22%,5,1%,106,12.41%
48395,Texas,Robertson County,16545,8170,8375,6195,6201,4740,4799,9539,7006,No,42.35%,3642,22%,3189,19.27%
48397,Texas,Rockwall County,83021,40758,42263,36225,37439,29698,31183,60881,22140,No,26.67%,5046,6%,13590,16.37%
48399,Texas,Runnels County,10449,5208,5241,4918,4971,3225,3386,6611,3838,No,36.73%,247,2%,3498,33.48%
48401,Texas,Rusk County,54026,28531,25495,22208,20520,17978,17278,35256,18770,No,34.74%,9596,18%,8215,15.21%
48403,Texas,Sabine County,10433,5099,5334,4597,4810,4450,4650,9100,1333,No,12.78%,772,7%,347,3.33%
48405,Texas,San Augustine County,8818,4299,4519,3257,3320,2995,3073,6068,2750,No,31.19%,2034,23%,585,6.63%
48407,Texas,San Jacinto County,27126,13590,13536,11732,11653,10306,10281,20587,6539,No,24.11%,2861,11%,3148,11.61%
48409,Texas,San Patricio County,65600,32779,32821,30931,31043,13595,13509,27104,38496,Yes,58.68%,1392,2%,36032,54.93%
48411,Texas,San Saba County,6002,3296,2706,3018,2604,2062,1925,3987,2015,No,33.57%,212,4%,1727,28.77%
48413,Texas,Schleicher County,3264,1646,1618,1592,1547,795,782,1577,1687,Yes,51.69%,48,1%,1623,49.72%
48415,Texas,Scurry County,17126,9200,7926,8282,7424,4927,4671,9598,7528,No,43.96%,874,5%,6467,37.76%
48417,Texas,Shackelford County,3356,1636,1720,1568,1659,1417,1513,2930,426,No,12.69%,46,1%,332,9.89%
48419,Texas,Shelby County,26019,12902,13117,10427,10374,8195,8465,16660,9359,No,35.97%,4566,18%,4520,17.37%
48421,Texas,Sherman County,3073,1581,1492,1529,1446,889,860,1749,1324,No,43.08%,16,1%,1269,41.30%
48423,Texas,Smith County,214821,103938,110883,82028,85810,63612,68524,132136,82685,No,38.49%,38998,18%,38559,17.95%
48425,Texas,Somervell County,8598,4236,4362,4031,4123,3267,3401,6668,1930,No,22.45%,89,1%,1637,19.04%
48427,Texas,Starr County,61615,29929,31686,29610,31378,1218,1210,2428,59187,Yes,96.06%,174,0%,58922,95.63%
48429,Texas,Stephens County,9464,4900,4564,4616,4411,3547,3501,7048,2416,No,25.53%,226,2%,2075,21.93%
48431,Texas,Sterling County,1191,612,579,579,548,363,346,709,482,No,40.47%,18,2%,438,36.78%
48433,Texas,Stonewall County,1475,720,755,666,700,571,610,1181,294,No,19.93%,58,4%,211,14.31%
48435,Texas,Sutton County,3950,1982,1968,1926,1917,755,769,1524,2426,Yes,61.42%,34,1%,2389,60.48%
48437,Texas,Swisher County,7891,4168,3723,3634,3377,1992,1959,3951,3940,No,49.93%,622,8%,3251,41.20%
48439,Texas,Tarrant County,1880153,922381,957772,709024,723160,465099,487834,952933,927220,No,49.32%,292864,16%,515640,27.43%
48441,Texas,Taylor County,133473,65166,68307,56545,59524,42873,45537,88410,45063,No,33.76%,10366,8%,30538,22.88%
48443,Texas,Terrell County,917,470,447,436,419,227,197,424,493,Yes,53.76%,9,1%,455,49.62%
48445,Texas,Terry County,12613,6664,5949,6075,5560,2795,2639,5434,7179,Yes,56.92%,651,5%,6479,51.37%
48447,Texas,Throckmorton County,1601,795,806,780,776,702,693,1395,206,No,12.87%,11,1%,167,10.43%
48449,Texas,Titus County,32663,16103,16560,13768,13997,7548,8106,15654,17009,Yes,52.07%,3439,11%,13177,40.34%
48451,Texas,Tom Green County,113281,55905,57376,50692,52468,31459,32604,64063,49218,No,43.45%,5267,5%,41574,36.70%
48453,Texas,Travis County,1095584,552937,542647,450863,436981,276294,272438,548732,546852,No,49.91%,98476,9%,370741,33.84%
48455,Texas,Trinity County,14309,6935,7374,6149,6437,5487,5881,11368,2941,No,20.55%,1362,10%,1300,9.09%
48457,Texas,Tyler County,21458,11567,9891,9679,8824,8581,8537,17118,4340,No,20.23%,2452,11%,1565,7.29%
48459,Texas,Upshur County,39995,19867,20128,17480,17575,16179,16351,32530,7465,No,18.66%,3545,9%,2831,7.08%
48461,Texas,Upton County,3283,1664,1619,1559,1513,761,726,1487,1796,Yes,54.71%,77,2%,1692,51.54%
48463,Texas,Uvalde County,26752,13136,13616,12634,13125,3691,3847,7538,19214,Yes,71.82%,293,1%,18727,70.00%
48465,Texas,Val Verde County,48705,24584,24121,23438,23151,4563,3696,8259,40446,Yes,83.04%,886,2%,39187,80.46%
48467,Texas,Van Zandt County,52427,25666,26761,24158,25156,21607,22973,44580,7847,No,14.97%,1532,3%,5100,9.73%
48469,Texas,Victoria County,89269,43658,45611,39080,40905,20323,21730,42053,47216,Yes,52.89%,6161,7%,39686,44.46%
48471,Texas,Walker County,68408,40333,28075,29101,21353,22256,17333,39589,28819,No,42.13%,15665,23%,11870,17.35%
48473,Texas,Waller County,44357,22000,22357,16201,15766,9741,10046,19787,24570,Yes,55.39%,10767,24%,13330,30.05%
48475,Texas,Ward County,10879,5332,5547,4849,5062,2258,2506,4764,6115,Yes,56.21%,553,5%,5435,49.96%
48477,Texas,Washington County,34093,16819,17274,13214,13598,10854,11472,22326,11767,No,34.51%,6197,18%,4907,14.39%
48479,Texas,Webb County,259172,126607,132565,123488,129782,5156,4214,9370,249802,Yes,96.38%,1684,1%,247257,95.40%
48481,Texas,Wharton County,41285,20298,20987,17007,17458,9282,9961,19243,22042,Yes,53.39%,5972,14%,15908,38.53%
48483,Texas,Wheeler County,5626,2810,2816,2641,2633,1924,1975,3899,1727,No,30.70%,153,3%,1459,25.93%
48485,Texas,Wichita County,131559,67749,63810,56186,53407,44862,44006,88868,42691,No,32.45%,14309,11%,22994,17.48%
48487,Texas,Wilbarger County,13258,6555,6703,5668,5869,3994,4168,8162,5096,No,38.44%,1157,9%,3610,27.23%
48489,Texas,Willacy County,22058,12007,10051,11304,9731,1177,978,2155,19903,Yes,90.23%,574,3%,19259,87.31%
48491,Texas,Williamson County,456232,224501,231731,190051,195604,140591,145983,286574,169658,No,37.19%,30454,7%,108120,23.70%
48493,Texas,Wilson County,44370,22099,22271,21097,21240,12857,12864,25721,18649,No,42.03%,805,2%,17265,38.91%
48495,Texas,Winkler County,7330,3726,3604,3498,3380,1503,1510,3013,4317,Yes,58.89%,211,3%,4060,55.39%
48497,Texas,Wise County,60432,30420,30012,29012,28822,23595,23957,47552,12880,No,21.31%,820,1%,10811,17.89%
48499,Texas,Wood County,42022,20639,21383,18990,19788,17171,18154,35325,6697,No,15.94%,2058,5%,3818,9.09%
48501,Texas,Yoakum County,8075,4034,4041,3834,3854,1466,1519,2985,5090,Yes,63.03%,117,1%,4907,60.77%
48503,Texas,Young County,18339,9062,9277,8621,8841,7050,7532,14582,3757,No,20.49%,285,2%,3160,17.23%
48505,Texas,Zapata County,14290,7201,7089,7105,7004,454,392,846,13444,Yes,94.08%,55,0%,13354,93.45%
48507,Texas,Zavala County,11961,5981,5980,5801,5799,390,365,755,11206,Yes,93.69%,142,1%,11104,92.84%
49001,Utah,Beaver County,6501,3354,3147,3184,2996,2862,2725,5587,914,No,14.06%,25,0%,692,10.64%
49003,Utah,Box Elder County,50171,25450,24721,24276,23645,22255,21886,44141,6030,No,12.02%,224,0%,4290,8.55%
49005,Utah,Cache County,115520,57425,58095,53772,54625,48476,49615,98091,17429,No,15.09%,959,1%,11722,10.15%
49007,Utah,Carbon County,21246,10543,10703,10029,10239,8781,9032,17813,3433,No,16.16%,125,1%,2691,12.67%
49009,Utah,Daggett County,1090,607,483,587,467,566,460,1026,64,No,5.87%,4,0%,35,3.21%
49011,Utah,Davis County,315809,158844,156965,147797,146090,135378,134111,269489,46320,No,14.67%,4227,1%,27544,8.72%
49013,Utah,Duchesne County,19244,9769,9475,9023,8664,8444,8191,16635,2609,No,13.56%,89,0%,1315,6.83%
49015,Utah,Emery County,10933,5558,5375,5416,5222,5097,4938,10035,898,No,8.21%,49,0%,661,6.05%
49017,Utah,Garfield County,5095,2658,2437,2529,2324,2401,2241,4642,453,No,8.89%,31,1%,257,5.04%
49019,Utah,Grand County,9328,4665,4663,4294,4313,3903,3887,7790,1538,No,16.49%,58,1%,934,10.01%
49021,Utah,Iron County,46750,23358,23392,21914,21943,20244,20354,40598,6152,No,13.16%,260,1%,3749,8.02%
49023,Utah,Juab County,10341,5294,5047,5110,4881,4934,4690,9624,717,No,6.93%,43,0%,437,4.23%
49025,Utah,Kane County,7221,3603,3618,3435,3500,3282,3373,6655,566,No,7.84%,29,0%,295,4.09%
49027,Utah,Millard County,12569,6437,6132,6158,5864,5357,5269,10626,1943,No,15.46%,50,0%,1626,12.94%
49029,Utah,Morgan County,9821,4965,4856,4862,4753,4777,4625,9402,419,No,4.27%,21,0%,250,2.55%
49031,Utah,Piute County,1524,787,737,764,719,710,667,1377,147,No,9.65%,3,0%,118,7.74%
49033,Utah,Rich County,2267,1146,1121,1127,1097,1064,1062,2126,141,No,6.22%,1,0%,102,4.50%
49035,Utah,Salt Lake County,1063842,534877,528965,475750,471620,389602,391028,780630,283212,No,26.62%,20445,2%,186217,17.50%
49037,Utah,San Juan County,14965,7539,7426,3755,3628,3484,3408,6892,8073,Yes,53.95%,66,0%,758,5.07%
49039,Utah,Sanpete County,27906,14588,13318,13636,12753,12329,11788,24117,3789,No,13.58%,273,1%,2650,9.50%
49041,Utah,Sevier County,20784,10551,10233,10232,9862,9789,9440,19229,1555,No,7.48%,50,0%,999,4.81%
49043,Utah,Summit County,38003,19590,18413,18822,17601,16648,15679,32327,5676,No,14.94%,259,1%,4426,11.65%
49045,Utah,Tooele County,59870,30291,29579,28705,28058,25355,24929,50284,9586,No,16.01%,473,1%,7101,11.86%
49047,Utah,Uintah County,34524,17554,16970,15650,14951,14424,13982,28406,6118,No,17.72%,173,1%,2645,7.66%
49049,Utah,Utah County,540504,271666,268838,254744,252237,226908,225849,452757,87747,No,16.23%,3713,1%,59434,11.00%
49051,Utah,Wasatch County,25273,12932,12341,12471,11866,10916,10459,21375,3898,No,15.42%,107,0%,3275,12.96%
49053,Utah,Washington County,144809,71640,73169,67220,68774,60795,62859,123654,21155,No,14.61%,1161,1%,14380,9.93%
49055,Utah,Wayne County,2737,1373,1364,1313,1316,1267,1265,2532,205,No,7.49%,5,0%,123,4.49%
49057,Utah,Weber County,236640,118796,117844,110482,109723,91744,91964,183708,52932,No,22.37%,3794,2%,40710,17.20%
50001,Vermont,Addison County,36745,18357,18388,17560,17560,17242,17286,34528,2217,No,6.03%,342,1%,693,1.89%
50003,Vermont,Bennington County,36697,17809,18888,17213,18290,16998,18020,35018,1679,No,4.58%,309,1%,588,1.60%
50005,Vermont,Caledonia County,31121,15495,15626,14949,15122,14787,14959,29746,1375,No,4.42%,195,1%,390,1.25%
50007,Vermont,Chittenden County,158504,77549,80955,71549,74766,70270,73481,143751,14753,No,9.31%,3482,2%,3158,1.99%
50009,Vermont,Essex County,6226,3152,3074,3075,2976,3044,2947,5991,235,No,3.77%,27,0%,68,1.09%
50011,Vermont,Franklin County,48214,23872,24342,22841,23295,22568,23044,45612,2602,No,5.40%,284,1%,637,1.32%
50013,Vermont,Grand Isle County,6983,3489,3494,3332,3330,3278,3295,6573,410,No,5.87%,36,1%,109,1.56%
50015,Vermont,Lamoille County,24958,12446,12512,12020,12108,11870,11944,23814,1144,No,4.58%,186,1%,352,1.41%
50017,Vermont,Orange County,28924,14392,14532,14001,14071,13866,13914,27780,1144,No,3.96%,141,0%,341,1.18%
50019,Vermont,Orleans County,27109,13617,13492,13187,13081,13041,12962,26003,1106,No,4.08%,196,1%,327,1.21%
50021,Vermont,Rutland County,60869,30007,30862,29184,30028,28888,29711,58599,2270,No,3.73%,340,1%,727,1.19%
50023,Vermont,Washington County,59465,29367,30098,28221,28948,27773,28491,56264,3201,No,5.38%,527,1%,1040,1.75%
50025,Vermont,Windham County,43985,21690,22295,20766,21277,20378,20932,41310,2675,No,6.08%,464,1%,893,2.03%
50027,Vermont,Windsor County,56211,27536,28675,26616,27684,26304,27384,53688,2523,No,4.49%,350,1%,734,1.31%
51001,Virginia,Accomack County,33341,16258,17083,11425,11562,9914,10372,20286,13055,No,39.16%,9422,28%,3030,9.09%
51003,Virginia,Albemarle County,102251,48936,53315,40469,43831,37866,41585,79451,22800,No,22.30%,10142,10%,5729,5.60%
51005,Virginia,Alleghany County,16230,7925,8305,7356,7771,7244,7692,14936,1294,No,7.97%,793,5%,226,1.39%
51007,Virginia,Amelia County,12759,6255,6504,4729,4789,4574,4679,9253,3506,No,27.48%,2898,23%,350,2.74%
51009,Virginia,Amherst County,32384,15461,16923,11948,13204,11646,12926,24572,7812,No,24.12%,6080,19%,666,2.06%
51011,Virginia,Appomattox County,15128,7364,7764,5755,5994,5686,5917,11603,3525,No,23.30%,3040,20%,179,1.18%
51013,Virginia,Arlington County,221045,110373,110672,86360,84608,70989,70111,141100,79945,No,36.17%,19592,9%,34011,15.39%
51015,Virginia,Augusta County,73658,37247,36411,34574,34625,33772,33975,67747,5911,No,8.02%,2977,4%,1656,2.25%
51017,Virginia,Bath County,4652,2330,2322,2156,2195,2131,2160,4291,361,No,7.76%,225,5%,79,1.70%
51019,Virginia,Bedford County,69590,34515,35075,31545,32045,31005,31500,62505,7085,No,10.18%,4150,6%,1257,1.81%
51021,Virginia,Bland County,6738,3734,3004,3491,2944,3467,2934,6401,337,No,5.00%,234,3%,41,0.61%
51023,Virginia,Botetourt County,33154,16371,16783,15483,15925,15300,15746,31046,2108,No,6.36%,1076,3%,451,1.36%
51025,Virginia,Brunswick County,17010,8911,8099,3598,3484,3458,3401,6859,10151,Yes,59.68%,9628,57%,314,1.85%
51027,Virginia,Buchanan County,23859,12219,11640,11505,11480,11449,11437,22886,973,No,4.08%,658,3%,114,0.48%
51029,Virginia,Buckingham County,17088,9406,7682,5709,4969,5538,4871,10409,6679,No,39.09%,6003,35%,332,1.94%
51031,Virginia,Campbell County,55163,26702,28461,22145,23485,21676,23050,44726,10437,No,18.92%,7905,14%,1032,1.87%
51033,Virginia,Caroline County,28972,14254,14718,9579,9755,9156,9361,18517,10455,No,36.09%,8314,29%,1086,3.75%
51035,Virginia,Carroll County,29851,14814,15037,14513,14768,14075,14412,28487,1364,No,4.57%,222,1%,870,2.91%
51036,Virginia,Charles City County,7157,3547,3610,1548,1439,1507,1413,2920,4237,Yes,59.20%,3435,48%,119,1.66%
51037,Virginia,Charlotte County,12404,6125,6279,4220,4217,4123,4136,8259,4145,No,33.42%,3707,30%,258,2.08%
51041,Virginia,Chesterfield County,323856,155803,168053,111434,116595,101188,107565,208753,115103,No,35.54%,74512,23%,24252,7.49%
51043,Virginia,Clarke County,14323,7136,7187,6471,6548,6248,6340,12588,1735,No,12.11%,777,5%,501,3.50%
51045,Virginia,Craig County,5213,2587,2626,2550,2587,2540,2567,5107,106,No,2.03%,14,0%,45,0.86%
51047,Virginia,Culpeper County,47911,24157,23754,18888,19032,17039,17422,34461,13450,No,28.07%,7615,16%,4288,8.95%
51049,Virginia,Cumberland County,9849,4762,5087,3124,3205,3031,3141,6172,3677,No,37.33%,3234,33%,222,2.25%
51051,Virginia,Dickenson County,15690,7932,7758,7843,7662,7799,7613,15412,278,No,1.77%,58,0%,105,0.67%
51053,Virginia,Dinwiddie County,27994,13758,14236,9079,9041,8776,8784,17560,10434,No,37.27%,9178,33%,765,2.73%
51057,Virginia,Essex County,11233,5282,5951,3076,3388,2935,3288,6223,5010,No,44.60%,4308,38%,374,3.33%
51059,Virginia,Fairfax County,1118602,553148,565454,379235,378140,297606,300128,597734,520868,No,46.56%,109029,10%,179918,16.08%
51061,Virginia,Fauquier County,66542,32860,33682,28835,29341,26785,27480,54265,12277,No,18.45%,5542,8%,4436,6.67%
51063,Virginia,Floyd County,15390,7702,7688,7420,7417,7204,7263,14467,923,No,6.00%,291,2%,423,2.75%
51065,Virginia,Fluvanna County,25967,11908,14059,9900,11253,9545,10904,20449,5518,No,21.25%,4055,16%,833,3.21%
51067,Virginia,Franklin County,56411,27832,28579,24919,25593,24247,25028,49275,7136,No,12.65%,4682,8%,1492,2.64%
51069,Virginia,Frederick County,80317,39896,40421,36559,37193,33967,34829,68796,11521,No,14.34%,3616,5%,5598,6.97%
51071,Virginia,Giles County,16928,8315,8613,8060,8359,7958,8257,16215,713,No,4.21%,253,1%,221,1.31%
51073,Virginia,Gloucester County,36886,18233,18653,16048,16406,15640,16000,31640,5246,No,14.22%,3124,8%,990,2.68%
51075,Virginia,Goochland County,21347,10565,10782,8337,8588,8155,8383,16538,4809,No,22.53%,3813,18%,470,2.20%
51077,Virginia,Grayson County,15183,7453,7730,7177,7470,6953,7287,14240,943,No,6.21%,338,2%,434,2.86%
51079,Virginia,Greene County,18771,9274,9497,8283,8497,7903,8149,16052,2719,No,14.49%,1254,7%,847,4.51%
51081,Virginia,Greensville County,11851,7294,4557,2793,1798,2693,1767,4460,7391,Yes,62.37%,7089,60%,186,1.57%
51083,Virginia,Halifax County,35849,17103,18746,10618,11399,10348,11185,21533,14316,No,39.93%,13172,37%,644,1.80%
51085,Virginia,Hanover County,100668,49402,51266,43076,44532,42027,43604,85631,15037,No,14.94%,9675,10%,2388,2.37%
51087,Virginia,Henrico County,314932,148418,166514,90779,98905,84016,92836,176852,138080,No,43.84%,94638,30%,16265,5.16%
51089,Virginia,Henry County,52969,25579,27390,19427,20639,18136,19556,37692,15277,No,28.84%,11607,22%,2742,5.18%
51091,Virginia,Highland County,2245,1117,1128,1104,1118,1090,1112,2202,43,No,1.92%,9,0%,21,0.94%
51093,Virginia,Isle of Wight County,35399,17269,18130,12723,12904,12447,12623,25070,10329,No,29.18%,8663,24%,749,2.12%
51095,Virginia,James City County,68967,33297,35670,27130,28931,25620,27450,53070,15897,No,23.05%,9314,14%,3540,5.13%
51097,Virginia,King and Queen County,7046,3489,3557,2433,2424,2318,2334,4652,2394,No,33.98%,1898,27%,239,3.39%
51099,Virginia,King George County,24500,12353,12147,9620,9291,9194,8919,18113,6387,No,26.07%,4380,18%,1006,4.11%
51101,Virginia,King William County,15981,7791,8190,6083,6320,5944,6181,12125,3856,No,24.13%,2846,18%,348,2.18%
51103,Virginia,Lancaster County,11236,5276,5960,3716,4176,3660,4100,7760,3476,No,30.94%,3131,28%,172,1.53%
51105,Virginia,Lee County,25474,13271,12203,12111,12005,11824,11936,23760,1714,No,6.73%,983,4%,438,1.72%
51107,Virginia,Loudoun County,336898,166816,170082,121394,122233,101923,103345,205268,131630,No,39.07%,25815,8%,43040,12.78%
51109,Virginia,Louisa County,33430,16475,16955,13175,13415,12828,13111,25939,7491,No,22.41%,5792,17%,808,2.42%
51111,Virginia,Lunenburg County,12588,6642,5946,4134,3833,3925,3673,7598,4990,No,39.64%,4305,34%,492,3.91%
51113,Virginia,Madison County,13200,6412,6788,5541,5935,5420,5812,11232,1968,No,14.91%,1309,10%,275,2.08%
51115,Virginia,Mathews County,8884,4307,4577,3808,4034,3735,3962,7697,1187,No,13.36%,809,9%,158,1.78%
51117,Virginia,Mecklenburg County,31749,15338,16411,9501,10105,9125,9855,18980,12769,No,40.22%,11308,36%,811,2.55%
51119,Virginia,Middlesex County,10822,5368,5454,4187,4402,4082,4348,8430,2392,No,22.10%,1966,18%,202,1.87%
51121,Virginia,Montgomery County,95194,49289,45905,42917,40769,41655,39753,81408,13786,No,14.48%,3873,4%,2714,2.85%
51125,Virginia,Nelson County,14827,7215,7612,6137,6355,5915,6192,12107,2720,No,18.34%,1928,13%,499,3.37%
51127,Virginia,New Kent County,19169,9744,9425,7969,7780,7749,7624,15373,3796,No,19.80%,2634,14%,444,2.32%
51131,Virginia,Northampton County,12226,5863,6363,3697,3718,3178,3387,6565,5661,No,46.30%,4485,37%,958,7.84%
51133,Virginia,Northumberland County,12346,6061,6285,4460,4540,4260,4384,8644,3702,No,29.99%,3114,25%,412,3.34%
51135,Virginia,Nottoway County,15830,8436,7394,4766,4408,4477,4253,8730,7100,No,44.85%,6271,40%,642,4.06%
51137,Virginia,Orange County,34246,16833,17413,14023,14409,13452,13882,27334,6912,No,20.18%,4524,13%,1325,3.87%
51139,Virginia,Page County,23895,11784,12111,11300,11682,11110,11514,22624,1271,No,5.32%,513,2%,416,1.74%
51141,Virginia,Patrick County,18451,9060,9391,8347,8679,8121,8485,16606,1845,No,10.00%,1100,6%,466,2.53%
51143,Virginia,Pittsylvania County,62807,30863,31944,23647,24261,22941,23758,46699,16108,No,25.65%,13778,22%,1424,2.27%
51145,Virginia,Powhatan County,28123,15152,12971,12300,11524,12064,11328,23392,4731,No,16.82%,3732,13%,520,1.85%
51147,Virginia,Prince Edward County,23238,11554,11684,7412,7348,7208,7189,14397,8841,No,38.05%,7792,34%,550,2.37%
51149,Virginia,Prince George County,36941,20368,16573,12155,10721,11107,9996,21103,15838,No,42.87%,11993,32%,2479,6.71%
51153,Virginia,Prince William County,430289,213820,216469,141918,138857,102315,102102,204417,225872,Yes,52.49%,91547,21%,90133,20.95%
51155,Virginia,Pulaski County,34736,17284,17452,15915,16222,15688,16050,31738,2998,No,8.63%,1825,5%,467,1.34%
51157,Virginia,Rappahannock County,7456,3694,3762,3420,3496,3324,3385,6709,747,No,10.02%,352,5%,227,3.04%
51159,Virginia,Richmond County,9059,5066,3993,3138,2925,2838,2736,5574,3485,No,38.47%,2760,30%,534,5.89%
51161,Virginia,Roanoke County,92901,44385,48516,39834,43608,38860,42641,81501,11400,No,12.27%,5029,5%,2232,2.40%
51163,Virginia,Rockbridge County,22394,11071,11323,10482,10693,10354,10552,20906,1488,No,6.64%,644,3%,314,1.40%
51165,Virginia,Rockingham County,77391,37840,39551,36012,37908,34116,36128,70244,7147,No,9.23%,1470,2%,4400,5.69%
51167,Virginia,Russell County,28445,13914,14531,13631,14249,13500,14150,27650,795,No,2.79%,268,1%,281,0.99%
51169,Virginia,Scott County,22781,11413,11368,11197,11172,11060,11073,22133,648,No,2.84%,160,1%,268,1.18%
51171,Virginia,Shenandoah County,42583,20820,21763,19796,20819,18498,19730,38228,4355,No,10.23%,895,2%,2705,6.35%
51173,Virginia,Smyth County,31718,15466,16252,14897,15662,14648,15408,30056,1662,No,5.24%,672,2%,570,1.80%
51175,Virginia,Southampton County,18409,9554,8855,5752,5422,5680,5357,11037,7372,No,40.05%,6859,37%,222,1.21%
51177,Virginia,Spotsylvania County,125684,61563,64121,48237,50094,44002,45954,89956,35728,No,28.43%,19851,16%,9997,7.95%
51179,Virginia,Stafford County,134352,67510,66842,51205,49487,45684,43976,89660,44692,No,33.26%,23688,18%,13411,9.98%
51181,Virginia,Surry County,6844,3376,3468,1822,1747,1793,1714,3507,3337,No,48.76%,3112,45%,100,1.46%
51183,Virginia,Sussex County,11972,7073,4899,2712,2151,2596,2075,4671,7301,Yes,60.98%,6898,58%,280,2.34%
51185,Virginia,Tazewell County,44268,21976,22292,20624,21403,20445,21281,41726,2542,No,5.74%,1456,3%,343,0.77%
51187,Virginia,Warren County,38070,18926,19144,17335,17541,16729,16909,33638,4432,No,11.64%,1855,5%,1414,3.71%
51191,Virginia,Washington County,55190,27165,28025,26345,27254,25933,26971,52904,2286,No,4.14%,780,1%,753,1.36%
51193,Virginia,Westmoreland County,17524,8544,8980,5889,6103,5368,5751,11119,6405,No,36.55%,4874,28%,1057,6.03%
51195,Virginia,Wise County,40918,21128,19790,19056,19153,18803,18972,37775,3143,No,7.68%,2078,5%,502,1.23%
51197,Virginia,Wythe County,29251,14251,15000,13541,14277,13400,14179,27579,1672,No,5.72%,890,3%,295,1.01%
51199,Virginia,York County,66146,32429,33717,25425,25758,24122,24428,48550,17596,No,26.60%,8888,13%,3368,5.09%
51510,Virginia,Alexandria city,146294,70833,75461,47970,50148,37197,40077,77274,69020,No,47.18%,32633,22%,24531,16.77%
51515,Virginia,Bedford city,5964,2729,3235,2102,2474,2041,2428,4469,1495,No,25.07%,1221,20%,140,2.35%
51520,Virginia,Bristol city,17662,8288,9374,7512,8625,7396,8512,15908,1754,No,9.93%,993,6%,276,1.56%
51530,Virginia,Buena Vista city,6707,3128,3579,2856,3277,2804,3207,6011,696,No,10.38%,344,5%,129,1.92%
51540,Virginia,Charlottesville city,43956,21218,22738,15084,15817,14121,15032,29153,14803,No,33.68%,8571,19%,2176,4.95%
51550,Virginia,Chesapeake city,228417,111596,116821,71877,72438,67700,68628,136328,92089,No,40.32%,68781,30%,10997,4.81%
51570,Virginia,Colonial Heights city,17479,8105,9374,6716,7606,6406,7291,13697,3782,No,21.64%,2088,12%,804,4.60%
51580,Virginia,Covington city,5771,2829,2942,2365,2478,2295,2435,4730,1041,No,18.04%,755,13%,125,2.17%
51590,Virginia,Danville city,42996,19747,23249,9596,10962,9019,10480,19499,23497,Yes,54.65%,21231,49%,1337,3.11%
51595,Virginia,Emporia city,5740,2681,3059,893,1019,777,933,1710,4030,Yes,70.21%,3674,64%,281,4.90%
51600,Virginia,Fairfax city,23461,11518,11943,8521,8892,6819,7235,14054,9407,No,40.10%,1326,6%,3822,16.29%
51610,Virginia,Falls Church city,13229,6509,6720,5339,5407,4823,4808,9631,3598,No,27.20%,629,5%,1247,9.43%
51620,Virginia,Franklin city,8528,3838,4690,1575,1791,1525,1731,3256,5272,Yes,61.82%,4858,57%,175,2.05%
51630,Virginia,Fredericksburg city,27307,12513,14794,8563,10050,7406,8907,16313,10994,No,40.26%,6643,24%,3002,10.99%
51640,Virginia,Galax city,6908,3222,3686,2898,3351,2464,2911,5375,1533,No,22.19%,448,6%,973,14.09%
51650,Virginia,Hampton city,136836,65603,71233,30136,29580,28010,27604,55614,81222,Yes,59.36%,68218,50%,6844,5.00%
51660,Virginia,Harrisonburg city,50981,24163,26818,20352,23040,16328,19401,35729,15252,No,29.92%,3930,8%,8870,17.40%
51670,Virginia,Hopewell city,22348,10341,12007,6002,6701,5433,6218,11651,10697,No,47.87%,8672,39%,1471,6.58%
51678,Virginia,Lexington city,6998,3895,3103,3338,2642,3195,2537,5732,1266,No,18.09%,696,10%,284,4.06%
51680,Virginia,Lynchburg city,77113,36314,40799,23952,26673,22940,25731,48671,28442,No,36.88%,22462,29%,2470,3.20%
51683,Virginia,Manassas city,40605,20396,20209,15177,15008,9104,9466,18570,22035,Yes,54.27%,6223,15%,13152,32.39%
51685,Virginia,Manassas Park city,15798,8051,7747,5771,5441,3199,3166,6365,9433,Yes,59.71%,2333,15%,5459,34.56%
51690,Virginia,Martinsville city,13733,6241,7492,3207,3849,2968,3647,6615,7118,Yes,51.83%,6231,45%,547,3.98%
51700,Virginia,Newport News city,180726,87374,93352,46409,45971,41309,41449,82758,97968,Yes,54.21%,74608,41%,14233,7.88%
51710,Virginia,Norfolk city,245782,128082,117700,67234,53506,60115,48707,108822,136960,Yes,55.72%,105988,43%,17623,7.17%
51720,Virginia,Norton city,4068,1904,2164,1695,1940,1634,1912,3546,522,No,12.83%,268,7%,96,2.36%
51730,Virginia,Petersburg city,31973,14847,17126,2805,2843,2396,2551,4947,27026,Yes,84.53%,25222,79%,1224,3.83%
51735,Virginia,Poquoson city,12097,5961,6136,5672,5818,5557,5703,11260,837,No,6.92%,122,1%,259,2.14%
51740,Virginia,Portsmouth city,96470,46401,50069,20339,20043,19245,19173,38418,58052,Yes,60.18%,51696,54%,3228,3.35%
51750,Virginia,Radford city,16685,7985,8700,6948,7539,6760,7362,14122,2563,No,15.36%,1424,9%,421,2.52%
51760,Virginia,Richmond city,210309,99907,110402,46407,46547,41233,42361,83594,126715,Yes,60.25%,105999,50%,13410,6.38%
51770,Virginia,Roanoke city,97469,46707,50762,31024,33406,28557,31441,59998,37471,No,38.44%,28158,29%,5599,5.74%
51775,Virginia,Salem city,24970,11933,13037,10612,11598,10299,11318,21617,3353,No,13.43%,1828,7%,730,2.92%
51790,Virginia,Staunton city,23921,10885,13036,9158,10950,8899,10691,19590,4331,No,18.11%,2948,12%,614,2.57%
51800,Virginia,Suffolk city,85181,41002,44179,22300,22399,21324,21536,42860,42321,No,49.68%,36717,43%,2761,3.24%
51810,Virginia,Virginia Beach city,447021,219579,227442,153921,155193,142049,143436,285485,161536,No,36.14%,89543,20%,32159,7.19%
51820,Virginia,Waynesboro city,21107,9974,11133,8425,9323,7766,8782,16548,4559,No,21.60%,2455,12%,1400,6.63%
51830,Virginia,Williamsburg city,15167,7066,8101,5403,6098,4944,5648,10592,4575,No,30.16%,2312,15%,1052,6.94%
51840,Virginia,Winchester city,26881,13303,13578,10918,11284,8841,9633,18474,8407,No,31.27%,2974,11%,4315,16.05%
53001,Washington,Adams County,19005,9689,9316,8902,8602,3473,3525,6998,12007,Yes,63.18%,230,1%,11591,60.99%
53003,Washington,Asotin County,21888,10539,11349,10014,10754,9720,10427,20147,1741,No,7.95%,116,1%,738,3.37%
53005,Washington,Benton County,182398,91368,91030,83534,83293,67032,67501,134533,47865,No,26.24%,2750,2%,34974,19.17%
53007,Washington,Chelan County,73687,36763,36924,34701,34883,25122,26187,51309,22378,No,30.37%,449,1%,19751,26.80%
53009,Washington,Clallam County,71863,35706,36157,31341,32021,29737,30692,60429,11434,No,15.91%,714,1%,3896,5.42%
53011,Washington,Clark County,438287,216660,221627,190524,194602,175106,179843,354949,83338,No,19.01%,9237,2%,35373,8.07%
53013,Washington,Columbia County,3995,1997,1998,1888,1894,1791,1783,3574,421,No,10.54%,21,1%,241,6.03%
53015,Washington,Cowlitz County,101996,50580,51416,46543,47381,42834,44127,86961,15035,No,14.74%,827,1%,8201,8.04%
53017,Washington,Douglas County,39350,19820,19530,18633,18355,12954,13316,26270,13080,No,33.24%,241,1%,11597,29.47%
53019,Washington,Ferry County,7705,3989,3716,3068,2841,2958,2756,5714,1991,No,25.84%,35,0%,296,3.84%
53021,Washington,Franklin County,85845,44791,41054,40786,37567,19226,17783,37009,48836,Yes,56.89%,2251,3%,43730,50.94%
53023,Washington,Garfield County,2228,1085,1143,1048,1085,998,1051,2049,179,No,8.03%,2,0%,103,4.62%
53025,Washington,Grant County,91723,46624,45099,43311,41947,25793,26013,51806,39917,No,43.52%,1592,2%,35922,39.16%
53027,Washington,Grays Harbor County,71692,36855,34837,32250,30952,29270,28533,57803,13889,No,19.37%,917,1%,6604,9.21%
53029,Washington,Island County,79177,39362,39815,34486,34343,32484,32378,64862,14315,No,18.08%,2068,3%,4918,6.21%
53031,Washington,Jefferson County,29854,14794,15060,13495,13790,13125,13431,26556,3298,No,11.05%,301,1%,935,3.13%
53033,Washington,King County,2007440,1001373,1006067,719764,711909,639504,640803,1280307,727133,No,36.22%,131316,7%,184754,9.20%
53035,Washington,Kitsap County,254991,129813,125178,109176,103964,102049,97594,199643,55348,No,21.71%,7609,3%,17301,6.78%
53037,Washington,Kittitas County,41672,21068,20604,19470,19011,17893,17560,35453,6219,No,14.92%,490,1%,3469,8.32%
53039,Washington,Klickitat County,20699,10439,10260,9734,9501,8634,8485,17119,3580,No,17.30%,100,0%,2376,11.48%
53041,Washington,Lewis County,75621,37820,37801,35231,35316,31986,32495,64481,11140,No,14.73%,514,1%,6930,9.16%
53043,Washington,Lincoln County,10437,5249,5188,4973,4895,4852,4765,9617,820,No,7.86%,31,0%,290,2.78%
53045,Washington,Mason County,60832,31432,29400,27891,26161,25651,24459,50110,10722,No,17.63%,800,1%,5117,8.41%
53047,Washington,Okanogan County,41275,20808,20467,17289,16998,13797,14056,27853,13422,No,32.52%,249,1%,7530,18.24%
53049,Washington,Pacific County,20575,10272,10303,9275,9352,8467,8717,17184,3391,No,16.48%,163,1%,1769,8.60%
53051,Washington,Pend Oreille County,12980,6615,6365,6070,5857,5895,5695,11590,1390,No,10.71%,78,1%,454,3.50%
53053,Washington,Pierce County,811681,402071,409610,310032,313517,279185,284907,564092,247589,No,30.50%,58458,7%,78131,9.63%
53055,Washington,San Juan County,15824,7667,8157,7276,7725,6877,7338,14215,1609,No,10.17%,89,1%,894,5.65%
53057,Washington,Skagit County,118222,58657,59565,53578,54353,44436,45657,90093,28129,No,23.79%,1029,1%,20435,17.29%
53059,Washington,Skamania County,11187,5656,5531,5320,5144,5037,4892,9929,1258,No,11.25%,60,1%,615,5.50%
53061,Washington,Snohomish County,733036,366957,366079,298998,296483,268637,269233,537870,195166,No,26.62%,21002,3%,68116,9.29%
53063,Washington,Spokane County,475735,235487,240248,211983,217049,202282,208043,410325,65410,No,13.75%,8658,2%,23078,4.85%
53065,Washington,Stevens County,43538,21865,21673,19702,19414,19228,18914,38142,5396,No,12.39%,203,0%,1292,2.97%
53067,Washington,Thurston County,258332,126336,131996,106162,110555,98049,102939,200988,57344,No,22.20%,8082,3%,19813,7.67%
53069,Washington,Wahkiakum County,3993,2002,1991,1894,1878,1851,1815,3666,327,No,8.19%,12,0%,132,3.31%
53071,Washington,Walla Walla County,59404,30135,29269,27686,27357,21749,21839,43588,15816,No,26.62%,1133,2%,12297,20.70%
53073,Washington,Whatcom County,205262,101681,103581,89330,91106,81927,84348,166275,38987,No,18.99%,2407,1%,17162,8.36%
53075,Washington,Whitman County,46606,23751,22855,20302,19427,19266,18438,37704,8902,No,19.10%,918,2%,2396,5.14%
53077,Washington,Yakima County,246977,123774,123203,109394,108999,55764,58710,114474,132503,Yes,53.65%,3508,1%,114378,46.31%
54001,West Virginia,Barbour County,16493,8094,8399,7823,8155,7775,8111,15886,607,No,3.68%,135,1%,111,0.67%
54003,West Virginia,Berkeley County,107098,53051,54047,46817,48213,45041,46590,91631,15467,No,14.44%,7889,7%,4039,3.77%
54005,West Virginia,Boone County,24478,12161,12317,11968,12153,11911,12106,24017,461,No,1.88%,146,1%,110,0.45%
54007,West Virginia,Braxton County,14468,7268,7200,7108,7080,7072,7050,14122,346,No,2.39%,69,0%,79,0.55%
54009,West Virginia,Brooke County,23853,11628,12225,11247,11868,11175,11804,22979,874,No,3.66%,327,1%,164,0.69%
54011,West Virginia,Cabell County,96974,47148,49826,43025,45695,42496,45225,87721,9253,No,9.54%,4948,5%,1198,1.24%
54013,West Virginia,Calhoun County,7607,3819,3788,3767,3719,3731,3684,7415,192,No,2.52%,20,0%,73,0.96%
54015,West Virginia,Clay County,9297,4637,4660,4572,4593,4545,4575,9120,177,No,1.90%,14,0%,47,0.51%
54017,West Virginia,Doddridge County,8178,4401,3777,4219,3701,4195,3665,7860,318,No,3.89%,123,2%,66,0.81%
54019,West Virginia,Fayette County,45869,23060,22809,21477,21405,21269,21250,42519,3350,No,7.30%,2169,5%,423,0.92%
54021,West Virginia,Gilmer County,8732,5248,3484,4001,3362,3643,3318,6961,1771,No,20.28%,1109,13%,510,5.84%
54023,West Virginia,Grant County,11816,5854,5962,5717,5855,5659,5810,11469,347,No,2.94%,101,1%,131,1.11%
54025,West Virginia,Greenbrier County,35820,17573,18247,16626,17339,16433,17155,33588,2232,No,6.23%,992,3%,463,1.29%
54027,West Virginia,Hampshire County,23709,12065,11644,11704,11340,11591,11236,22827,882,No,3.72%,278,1%,262,1.11%
54029,West Virginia,Hancock County,30305,14610,15695,13945,15074,13788,14936,28724,1581,No,5.22%,725,2%,340,1.12%
54031,West Virginia,Hardy County,13866,6998,6868,6586,6580,6366,6413,12779,1087,No,7.84%,398,3%,483,3.48%
54033,West Virginia,Harrison County,69141,33745,35396,32321,34101,31921,33675,65596,3545,No,5.13%,1160,2%,899,1.30%
54035,West Virginia,Jackson County,29234,14390,14844,14110,14575,14013,14495,28508,726,No,2.48%,103,0%,205,0.70%
54037,West Virginia,Jefferson County,54504,26900,27604,23878,24505,22657,23294,45951,8553,No,15.69%,3700,7%,2741,5.03%
54039,West Virginia,Kanawha County,192179,92405,99774,81912,89120,80999,88329,169328,22851,No,11.89%,14470,8%,2176,1.13%
54041,West Virginia,Lewis County,16371,8085,8286,7885,8120,7826,8070,15896,475,No,2.90%,98,1%,130,0.79%
54043,West Virginia,Lincoln County,21627,10768,10859,10648,10732,10590,10677,21267,360,No,1.66%,48,0%,121,0.56%
54045,West Virginia,Logan County,36168,17892,18276,17250,17641,17118,17502,34620,1548,No,4.28%,812,2%,298,0.82%
54047,West Virginia,McDowell County,21326,10519,10807,9450,9605,9388,9577,18965,2361,No,11.07%,1977,9%,105,0.49%
54049,West Virginia,Marion County,56678,27690,28988,26042,27419,25775,27161,52936,3742,No,6.60%,1975,3%,600,1.06%
54051,West Virginia,Marshall County,32674,15971,16703,15628,16357,15509,16222,31731,943,No,2.89%,202,1%,285,0.87%
54053,West Virginia,Mason County,27179,13094,14085,12782,13744,12710,13686,26396,783,No,2.88%,213,1%,141,0.52%
54055,West Virginia,Mercer County,62523,29976,32547,27396,29793,27182,29595,56777,5746,No,9.19%,3915,6%,534,0.85%
54057,West Virginia,Mineral County,27956,13891,14065,13206,13400,13113,13304,26417,1539,No,5.51%,830,3%,218,0.78%
54059,West Virginia,Mingo County,26103,12855,13248,12436,12826,12367,12764,25131,972,No,3.72%,484,2%,135,0.52%
54061,West Virginia,Monongalia County,100332,51720,48612,46734,44750,45793,44013,89806,10526,No,10.49%,3770,4%,1924,1.92%
54063,West Virginia,Monroe County,13463,6641,6822,6479,6645,6438,6605,13043,420,No,3.12%,101,1%,97,0.72%
54065,West Virginia,Morgan County,17471,8656,8815,8413,8568,8321,8500,16821,650,No,3.72%,131,1%,207,1.18%
54067,West Virginia,Nicholas County,26229,12925,13304,12695,13061,12614,12995,25609,620,No,2.36%,61,0%,155,0.59%
54069,West Virginia,Ohio County,44075,21038,23037,19569,21632,19399,21456,40855,3220,No,7.31%,1604,4%,419,0.95%
54071,West Virginia,Pendleton County,7566,3874,3692,3713,3553,3672,3517,7189,377,No,4.98%,177,2%,88,1.16%
54073,West Virginia,Pleasants County,7595,4060,3535,3909,3479,3885,3451,7336,259,No,3.41%,106,1%,60,0.79%
54075,West Virginia,Pocahontas County,8692,4473,4219,4369,4124,4319,4085,8404,288,No,3.31%,70,1%,94,1.08%
54077,West Virginia,Preston County,33832,17376,16456,16895,16127,16753,16022,32775,1057,No,3.12%,392,1%,272,0.80%
54079,West Virginia,Putnam County,56435,27763,28672,26871,27732,26640,27495,54135,2300,No,4.08%,574,1%,530,0.94%
54081,West Virginia,Raleigh County,79021,39522,39499,34653,35689,34077,35388,69465,9556,No,12.09%,6441,8%,1098,1.39%
54083,West Virginia,Randolph County,29384,15165,14219,14613,13943,14504,13857,28361,1023,No,3.48%,396,1%,219,0.75%
54085,West Virginia,Ritchie County,10236,5107,5129,5030,5067,4995,5030,10025,211,No,2.06%,33,0%,77,0.75%
54087,West Virginia,Roane County,14684,7281,7403,7153,7275,7096,7208,14304,380,No,2.59%,39,0%,136,0.93%
54089,West Virginia,Summers County,13737,6142,7595,5915,6862,5854,6750,12604,1133,No,8.25%,693,5%,212,1.54%
54091,West Virginia,Taylor County,16991,8598,8393,8334,8224,8272,8141,16413,578,No,3.40%,156,1%,159,0.94%
54093,West Virginia,Tucker County,6995,3555,3440,3493,3389,3477,3362,6839,156,No,2.23%,26,0%,51,0.73%
54095,West Virginia,Tyler County,9037,4447,4590,4392,4527,4366,4504,8870,167,No,1.85%,27,0%,56,0.62%
54097,West Virginia,Upshur County,24477,12111,12366,11805,12081,11691,11959,23650,827,No,3.38%,198,1%,264,1.08%
54099,West Virginia,Wayne County,41649,20311,21338,19951,21014,19860,20894,40754,895,No,2.15%,129,0%,230,0.55%
54101,West Virginia,Webster County,9043,4469,4574,4384,4516,4367,4501,8868,175,No,1.94%,27,0%,37,0.41%
54103,West Virginia,Wetzel County,16422,8073,8349,7937,8238,7885,8201,16086,336,No,2.05%,49,0%,100,0.61%
54105,West Virginia,Wirt County,5847,2939,2908,2882,2855,2867,2831,5698,149,No,2.55%,15,0%,45,0.77%
54107,West Virginia,Wood County,86701,41810,44891,40372,43349,40011,43005,83016,3685,No,4.25%,1019,1%,801,0.92%
54109,West Virginia,Wyoming County,23273,11553,11720,11334,11510,11282,11456,22738,535,No,2.30%,123,1%,112,0.48%
55001,Wisconsin,Adams County,20679,11207,9472,10241,9181,9749,9015,18764,1915,No,9.26%,685,3%,780,3.77%
55003,Wisconsin,Ashland County,15992,8015,7977,6804,6725,6713,6636,13349,2643,No,16.53%,72,0%,318,1.99%
55005,Wisconsin,Barron County,45733,22789,22944,21935,22116,21488,21687,43175,2558,No,5.59%,480,1%,1002,2.19%
55007,Wisconsin,Bayfield County,15099,7713,7386,6695,6347,6636,6290,12926,2173,No,14.39%,69,0%,195,1.29%
55009,Wisconsin,Brown County,253032,125414,127618,111649,114838,102985,107123,210108,42924,No,16.96%,6207,2%,19314,7.63%
55011,Wisconsin,Buffalo County,13333,6769,6564,6639,6452,6503,6376,12879,454,No,3.41%,52,0%,258,1.94%
55013,Wisconsin,Burnett County,15382,7795,7587,7168,6951,7072,6864,13936,1446,No,9.40%,87,1%,237,1.54%
55015,Wisconsin,Calumet County,49634,24876,24758,23798,23658,22906,22830,45736,3898,No,7.85%,266,1%,1862,3.75%
55017,Wisconsin,Chippewa County,62922,32616,30306,30743,29293,30363,29007,59370,3552,No,5.65%,998,2%,814,1.29%
55019,Wisconsin,Clark County,34435,17415,17020,17032,16635,16329,16079,32408,2027,No,5.89%,137,0%,1365,3.96%
55021,Wisconsin,Columbia County,56539,28755,27784,27476,26974,26750,26416,53166,3373,No,5.97%,788,1%,1485,2.63%
55023,Wisconsin,Crawford County,16560,8509,8051,8113,7895,8024,7843,15867,693,No,4.18%,311,2%,169,1.02%
55025,Wisconsin,Dane County,503523,249499,254024,215651,220419,201433,207989,409422,94101,No,18.69%,27213,5%,30786,6.11%
55027,Wisconsin,Dodge County,88415,46567,41848,43417,40839,41409,39324,80733,7682,No,8.69%,2439,3%,3725,4.21%
55029,Wisconsin,Door County,27817,13701,14116,13290,13749,12927,13458,26385,1432,No,5.15%,173,1%,746,2.68%
55031,Wisconsin,Douglas County,43785,21868,21917,20312,20491,20093,20287,40380,3405,No,7.78%,518,1%,534,1.22%
55033,Wisconsin,Dunn County,44072,22240,21832,21126,20767,20815,20508,41323,2749,No,6.24%,262,1%,665,1.51%
55035,Wisconsin,Eau Claire County,100677,49471,51206,46019,47900,45098,47147,92245,8432,No,8.38%,963,1%,2088,2.07%
55037,Wisconsin,Florence County,4482,2300,2182,2227,2123,2207,2109,4316,166,No,3.70%,19,0%,52,1.16%
55039,Wisconsin,Fond du Lac County,101843,50080,51763,47930,49439,45695,47487,93182,8661,No,8.50%,1434,1%,4626,4.54%
55041,Wisconsin,Forest County,9206,4694,4512,3860,3717,3821,3677,7498,1708,No,18.55%,88,1%,160,1.74%
55043,Wisconsin,Grant County,51087,26583,24504,25661,23940,25337,23698,49035,2052,No,4.02%,616,1%,661,1.29%
55045,Wisconsin,Green County,36909,18292,18617,17902,18187,17386,17739,35125,1784,No,4.83%,176,0%,1033,2.80%
55047,Wisconsin,Green Lake County,19039,9529,9510,9303,9310,8882,8942,17824,1215,No,6.38%,116,1%,844,4.43%
55049,Wisconsin,Iowa County,23807,11930,11877,11682,11630,11484,11479,22963,844,No,3.55%,109,0%,379,1.59%
55051,Wisconsin,Iron County,5934,2975,2959,2908,2891,2896,2879,5775,159,No,2.68%,10,0%,32,0.54%
55053,Wisconsin,Jackson County,20485,10905,9580,9644,8670,9364,8522,17886,2599,No,12.69%,428,2%,580,2.83%
55055,Wisconsin,Jefferson County,84498,42097,42401,40693,41074,37815,38542,76357,8141,No,9.63%,797,1%,5847,6.92%
55057,Wisconsin,Juneau County,26631,14047,12584,13096,12108,12725,11868,24593,2038,No,7.65%,585,2%,737,2.77%
55059,Wisconsin,Kenosha County,167936,83129,84807,73501,74534,64325,65785,130110,37826,No,22.52%,11853,7%,20462,12.18%
55061,Wisconsin,Kewaunee County,20624,10477,10147,10252,9913,10011,9714,19725,899,No,4.36%,86,0%,490,2.38%
55063,Wisconsin,La Crosse County,116461,56954,59507,52286,55145,51449,54422,105871,10590,No,9.09%,1673,1%,1880,1.61%
55065,Wisconsin,Lafayette County,16853,8571,8282,8397,8114,8091,7900,15991,862,No,5.11%,51,0%,611,3.63%
55067,Wisconsin,Langlade County,19646,9868,9778,9510,9455,9344,9325,18669,977,No,4.97%,98,0%,389,1.98%
55069,Wisconsin,Lincoln County,28392,14271,14121,13853,13829,13678,13698,27376,1016,No,3.58%,177,1%,343,1.21%
55071,Wisconsin,Manitowoc County,80671,40211,40460,38123,38501,36853,37501,74354,6317,No,7.83%,532,1%,2643,3.28%
55073,Wisconsin,Marathon County,134735,67642,67093,61951,61848,60475,60533,121008,13727,No,10.19%,1000,1%,3253,2.41%
55075,Wisconsin,Marinette County,41563,20692,20871,20127,20285,19892,20021,39913,1650,No,3.97%,160,0%,593,1.43%
55077,Wisconsin,Marquette County,15205,7730,7475,7531,7288,7315,7114,14429,776,No,5.10%,93,1%,425,2.80%
55078,Wisconsin,Menominee County,4340,2159,2181,268,262,253,245,498,3842,Yes,88.53%,31,1%,227,5.23%
55079,Wisconsin,Milwaukee County,955205,461547,493658,308075,318522,248794,263551,512345,442860,No,46.36%,259800,27%,132350,13.86%
55081,Wisconsin,Monroe County,45100,22790,22310,21771,21235,20944,20586,41530,3570,No,7.92%,604,1%,1709,3.79%
55083,Wisconsin,Oconto County,37442,19093,18349,18543,17766,18298,17504,35802,1640,No,4.38%,102,0%,599,1.60%
55085,Wisconsin,Oneida County,35714,17838,17876,17231,17303,17055,17131,34186,1528,No,4.28%,174,0%,426,1.19%
55087,Wisconsin,Outagamie County,178816,89229,89587,82334,82947,79200,80205,159405,19411,No,10.86%,1956,1%,6763,3.78%
55089,Wisconsin,Ozaukee County,86823,42598,44225,40511,42109,39524,41169,80693,6130,No,7.06%,1255,1%,2138,2.46%
55091,Wisconsin,Pepin County,7390,3743,3647,3668,3596,3634,3555,7189,201,No,2.72%,33,0%,92,1.24%
55093,Wisconsin,Pierce County,40814,20171,20643,19515,19971,19203,19684,38887,1927,No,4.72%,250,1%,691,1.69%
55095,Wisconsin,Polk County,43610,21908,21702,21281,21013,20994,20756,41750,1860,No,4.27%,133,0%,691,1.58%
55097,Wisconsin,Portage County,70433,35281,35152,33391,33418,32459,32559,65018,5415,No,7.69%,460,1%,2012,2.86%
55099,Wisconsin,Price County,13869,7018,6851,6813,6648,6745,6576,13321,548,No,3.95%,56,0%,176,1.27%
55101,Wisconsin,Racine County,194797,96400,98397,81522,83196,70688,73182,143870,50927,No,26.14%,22462,12%,23429,12.03%
55103,Wisconsin,Richland County,17818,8938,8880,8710,8663,8511,8482,16993,825,No,4.63%,99,1%,408,2.29%
55105,Wisconsin,Rock County,160418,78745,81673,71735,74482,65883,69111,134994,25424,No,15.85%,8195,5%,12636,7.88%
55107,Wisconsin,Rusk County,14316,7130,7186,6953,7014,6866,6927,13793,523,No,3.65%,81,1%,190,1.33%
55109,Wisconsin,St. Croix County,85242,42597,42645,41070,41172,40283,40412,80695,4547,No,5.33%,600,1%,1773,2.08%
55111,Wisconsin,Sauk County,62597,31169,31428,29992,30189,28610,29075,57685,4912,No,7.85%,437,1%,2843,4.54%
55113,Wisconsin,Sawyer County,16581,8367,8214,6644,6464,6560,6390,12950,3631,No,21.90%,88,1%,285,1.72%
55115,Wisconsin,Shawano County,41607,20797,20810,18626,18508,18293,18225,36518,5089,No,12.23%,157,0%,961,2.31%
55117,Wisconsin,Sheboygan County,115009,57776,57233,52685,52853,49464,50049,99513,15496,No,13.47%,1881,2%,6592,5.73%
55119,Wisconsin,Taylor County,20486,10435,10051,10255,9868,10095,9746,19841,645,No,3.15%,75,0%,333,1.63%
55121,Wisconsin,Trempealeau County,29297,14821,14476,14479,14136,13520,13490,27010,2287,No,7.81%,108,0%,1815,6.20%
55123,Wisconsin,Vernon County,30260,15142,15118,14836,14844,14625,14635,29260,1000,No,3.30%,120,0%,462,1.53%
55125,Wisconsin,Vilas County,21338,10787,10551,9394,9197,9303,9103,18406,2932,No,13.74%,56,0%,298,1.40%
55127,Wisconsin,Walworth County,102851,51475,51376,49552,49491,44015,44722,88737,14114,No,13.72%,1169,1%,11005,10.70%
55129,Wisconsin,Washburn County,15826,7796,8030,7524,7716,7428,7618,15046,780,No,4.93%,64,0%,232,1.47%
55131,Wisconsin,Washington County,132661,65801,66860,63462,64444,61759,62838,124597,8064,No,6.08%,1320,1%,3668,2.76%
55133,Wisconsin,Waukesha County,392292,192672,199620,181125,188107,172868,180326,353194,39098,No,9.97%,5319,1%,17347,4.42%
55135,Wisconsin,Waupaca County,52131,26292,25839,25700,25280,25029,24680,49709,2422,No,4.65%,184,0%,1402,2.69%
55137,Wisconsin,Waushara County,24461,12869,11592,12141,11252,11477,10574,22051,2410,No,9.85%,503,2%,1491,6.10%
55139,Wisconsin,Winnebago County,168794,84807,83987,78575,79113,75797,76430,152227,16567,No,9.81%,3197,2%,6222,3.69%
55141,Wisconsin,Wood County,74424,36685,37739,35077,36099,34251,35368,69619,4805,No,6.46%,485,1%,1819,2.44%
56001,Wyoming,Albany County,37276,19349,17927,17846,16562,16274,15150,31424,5852,No,15.70%,618,2%,3402,9.13%
56003,Wyoming,Big Horn County,11794,5922,5872,5690,5641,5240,5183,10423,1371,No,11.62%,107,1%,1015,8.61%
56005,Wyoming,Campbell County,47874,24950,22924,23772,21848,21909,20333,42242,5632,No,11.76%,421,1%,3818,7.98%
56007,Wyoming,Carbon County,15666,8594,7072,8077,6726,6647,5667,12314,3352,No,21.40%,229,1%,2683,17.13%
56009,Wyoming,Converse County,14008,7137,6871,6862,6600,6375,6191,12566,1442,No,10.29%,131,1%,992,7.08%
56011,Wyoming,Crook County,7155,3654,3501,3535,3389,3474,3296,6770,385,No,5.38%,81,1%,165,2.31%
56013,Wyoming,Fremont County,41110,20515,20595,15528,15440,14607,14594,29201,11909,No,28.97%,335,1%,2555,6.22%
56015,Wyoming,Goshen County,13636,7125,6511,6835,6297,6084,5722,11806,1830,No,13.42%,156,1%,1421,10.42%
56017,Wyoming,Hot Springs County,4822,2392,2430,2295,2318,2232,2258,4490,332,No,6.89%,28,1%,144,2.99%
56019,Wyoming,Johnson County,8615,4371,4244,4196,4047,4015,3918,7933,682,No,7.92%,102,1%,360,4.18%
56021,Wyoming,Laramie County,94483,47558,46925,43357,43109,37435,37292,74727,19756,No,20.91%,3086,3%,13272,14.05%
56023,Wyoming,Lincoln County,17961,9187,8774,8872,8476,8540,8125,16665,1296,No,7.22%,145,1%,774,4.31%
56025,Wyoming,Natrona County,78621,39750,38871,37385,36688,34732,34156,68888,9733,No,12.38%,1252,2%,5978,7.60%
56027,Wyoming,Niobrara County,2456,1119,1337,1086,1276,1064,1250,2314,142,No,5.78%,20,1%,53,2.16%
56029,Wyoming,Park County,28702,14298,14404,13713,13884,13003,13185,26188,2514,No,8.76%,259,1%,1544,5.38%
56031,Wyoming,Platte County,8756,4401,4355,4257,4218,3928,3951,7879,877,No,10.02%,51,1%,650,7.42%
56033,Wyoming,Sheridan County,29596,14755,14841,14044,14229,13504,13702,27206,2390,No,8.08%,293,1%,1216,4.11%
56035,Wyoming,Sublette County,10368,5622,4746,5359,4526,4907,4213,9120,1248,No,12.04%,123,1%,831,8.02%
56037,Wyoming,Sweetwater County,45267,23615,21652,22314,20480,18723,17390,36113,9154,No,20.22%,726,2%,7170,15.84%
56039,Wyoming,Teton County,21675,11345,10330,10841,9813,9160,8357,17517,4158,No,19.18%,182,1%,3382,15.60%
56041,Wyoming,Uinta County,21025,10645,10380,10212,9980,9310,9151,18461,2564,No,12.20%,123,1%,1904,9.06%
56043,Wyoming,Washakie County,8464,4249,4215,4060,4009,3522,3504,7026,1438,No,16.99%,41,0%,1185,14.00%
56045,Wyoming,Weston County,7082,3728,3354,3553,3205,3431,3118,6549,533,No,7.53%,46,1%,256,3.61%
01001,Alabama,Autauga County,55514,27053,28461,21383,22185,20768,21621,42389,13125,No,23.64%,10211,18%,1425,2.57%
01003,Alabama,Baldwin County,190790,93035,97755,81423,85193,77118,81630,158748,32042,No,16.79%,18283,10%,8737,4.58%
01005,Alabama,Barbour County,27201,14602,12599,7397,6338,6760,5874,12634,14567,Yes,53.55%,12884,47%,1385,5.09%
01007,Alabama,Bibb County,22597,12195,10402,8903,8326,8627,8220,16847,5750,No,25.45%,5030,22%,462,2.04%
01009,Alabama,Blount County,57826,28603,29223,27498,28129,24872,26065,50937,6889,No,11.91%,994,2%,4974,8.60%
01011,Alabama,Bullock County,10474,5701,4773,1762,1086,1497,871,2368,8106,Yes,77.39%,7304,70%,798,7.62%
01013,Alabama,Butler County,20307,9498,10809,5293,5760,5208,5693,10901,9406,No,46.32%,8843,44%,243,1.20%
01015,Alabama,Calhoun County,117296,56483,60813,43426,45751,41583,44232,85815,31481,No,26.84%,24597,21%,4068,3.47%
01017,Alabama,Chambers County,34064,16256,17808,9762,10314,9503,10133,19636,14428,No,42.36%,13319,39%,631,1.85%
01019,Alabama,Cherokee County,26021,12923,13098,12007,12232,11851,12058,23909,2112,No,8.12%,1207,5%,370,1.42%
01021,Alabama,Chilton County,43819,21634,22185,18985,19437,17266,18159,35425,8394,No,19.16%,4451,10%,3396,7.75%
01023,Alabama,Choctaw County,13633,6508,7125,3722,3903,3688,3877,7565,6068,No,44.51%,5887,43%,90,0.66%
01025,Alabama,Clarke County,25161,11888,13273,6644,7018,6543,6927,13470,11691,No,46.46%,11117,44%,289,1.15%
01027,Alabama,Clay County,13435,6640,6795,5508,5658,5283,5493,10776,2659,No,19.79%,1956,15%,428,3.19%
01029,Alabama,Cleburne County,14832,7361,7471,6974,7059,6789,6951,13740,1092,No,7.36%,546,4%,320,2.16%
01031,Alabama,Coffee County,51252,25371,25881,19681,19690,18260,18540,36800,14452,No,28.20%,8947,17%,3264,6.37%
01033,Alabama,Colbert County,54446,26211,28235,21383,22713,20775,22268,43043,11403,No,20.94%,8920,16%,1256,2.31%
01035,Alabama,Conecuh County,12981,6263,6718,3384,3357,3317,3314,6631,6350,No,48.92%,5999,46%,221,1.70%
01037,Alabama,Coosa County,10966,5438,5528,3698,3660,3614,3616,7230,3736,No,34.07%,3378,31%,226,2.06%
01039,Alabama,Covington County,37955,18365,19590,15594,16534,15338,16307,31645,6310,No,16.62%,4828,13%,612,1.61%
01041,Alabama,Crenshaw County,14083,6826,7257,4941,5146,4813,5066,9879,4204,No,29.85%,3395,24%,251,1.78%
01043,Alabama,Cullman County,80440,39814,40626,38368,39213,36603,37734,74337,6103,No,7.59%,1031,1%,3532,4.39%
01045,Alabama,Dale County,50444,24943,25501,19122,18816,17861,17732,35593,14851,No,29.44%,9979,20%,2941,5.83%
01047,Alabama,Dallas County,42864,19877,22987,5996,6437,5869,6369,12238,30626,Yes,71.45%,29818,70%,369,0.86%
01049,Alabama,DeKalb County,71080,35061,36019,32422,33290,28075,29379,57454,13626,No,19.17%,1432,2%,9999,14.07%
01051,Alabama,Elmore County,80629,39041,41588,29602,31891,28721,30973,59694,20935,No,25.96%,16950,21%,2170,2.69%
01053,Alabama,Escambia County,37994,19590,18404,11935,11794,11555,11558,23113,14881,No,39.17%,12243,32%,776,2.04%
01055,Alabama,Etowah County,104392,50549,53843,41420,43588,39850,42277,82127,22265,No,21.33%,16208,16%,3769,3.61%
01057,Alabama,Fayette County,16983,8444,8539,7319,7385,7206,7299,14505,2478,No,14.59%,1994,12%,243,1.43%
01059,Alabama,Franklin County,31761,15825,15936,14540,14782,12117,12922,25039,6722,No,21.16%,1357,4%,4892,15.40%
01061,Alabama,Geneva County,26931,13163,13768,11555,11947,11083,11590,22673,4258,No,15.81%,2671,10%,940,3.49%
01063,Alabama,Greene County,8876,4244,4632,844,806,822,776,1598,7278,Yes,82.00%,7138,80%,90,1.01%
01065,Alabama,Hale County,15388,7338,8050,3123,3137,3057,3095,6152,9236,Yes,60.02%,8966,58%,160,1.04%
01067,Alabama,Henry County,17287,8307,8980,5892,6188,5708,6034,11742,5545,No,32.08%,4860,28%,428,2.48%
01069,Alabama,Houston County,103402,49540,53862,35355,37472,33953,36188,70141,33261,No,32.17%,27306,26%,3318,3.21%
01071,Alabama,Jackson County,53019,26102,26917,23956,24748,23374,24288,47662,5357,No,10.10%,1803,3%,1403,2.65%
01073,Alabama,Jefferson County,660009,312146,347863,174345,184298,162330,174836,337166,322843,No,48.91%,281061,43%,25913,3.93%
01075,Alabama,Lamar County,14259,6931,7328,6076,6335,5989,6259,12248,2011,No,14.10%,1621,11%,191,1.34%
01077,Alabama,Lauderdale County,92542,44292,48250,38730,41927,37790,41047,78837,13705,No,14.81%,9371,10%,2221,2.40%
01079,Alabama,Lawrence County,33838,16435,17403,12909,13504,12626,13242,25868,7970,No,23.55%,3915,12%,679,2.01%
01081,Alabama,Lee County,147257,72632,74625,53220,52798,50749,50890,101639,45618,No,30.98%,34177,23%,5338,3.62%
01083,Alabama,Limestone County,87654,44280,43374,36411,36073,34151,34185,68336,19318,No,22.04%,11567,13%,5040,5.75%
01085,Alabama,Lowndes County,10857,5127,5730,1389,1366,1363,1354,2717,8140,Yes,74.97%,7973,73%,109,1.00%
01087,Alabama,Macon County,20535,9473,11062,1747,1688,1673,1632,3305,17230,Yes,83.91%,16736,81%,320,1.56%
01089,Alabama,Madison County,343080,168007,175073,119184,119909,111938,113996,225934,117146,No,34.15%,84265,25%,16081,4.69%
01091,Alabama,Marengo County,20401,9583,10818,4668,4977,4522,4822,9344,11057,Yes,54.20%,10481,51%,409,2.00%
01093,Alabama,Marion County,30327,14920,15407,13989,14632,13648,14349,27997,2330,No,7.68%,1154,4%,703,2.32%
01095,Alabama,Marshall County,94776,46635,48141,43789,45485,37872,40669,78541,16235,No,17.13%,2054,2%,12136,12.80%
01097,Alabama,Mobile County,413936,198332,215604,122412,127929,117919,124058,241977,171959,No,41.54%,145591,35%,10544,2.55%
01099,Alabama,Monroe County,22602,10801,11801,6104,6424,6028,6333,12361,10241,No,45.31%,9359,41%,239,1.06%
01101,Alabama,Montgomery County,230149,109367,120782,45598,46894,42103,44152,86255,143894,Yes,62.52%,128448,56%,8044,3.50%
01103,Alabama,Morgan County,120395,59329,61066,49886,51069,45285,47379,92664,27731,No,23.03%,14914,12%,9434,7.84%
01105,Alabama,Perry County,10181,4747,5434,1534,1599,1488,1570,3058,7123,Yes,69.96%,6928,68%,119,1.17%
01107,Alabama,Pickens County,19405,9241,10164,5442,5598,5311,5511,10822,8583,No,44.23%,8048,41%,354,1.82%
01109,Alabama,Pike County,33182,15844,17338,9567,9918,9227,9689,18916,14266,No,42.99%,12293,37%,783,2.36%
01111,Alabama,Randolph County,22675,10958,11717,8614,9087,8289,8800,17089,5586,No,24.64%,4530,20%,679,2.99%
01113,Alabama,Russell County,57820,28223,29597,15614,15675,14562,14776,29338,28482,No,49.26%,24467,42%,2680,4.64%
01115,Alabama,St. Clair County,85237,42631,42606,37454,38104,36562,37367,73929,11308,No,13.27%,7685,9%,1886,2.21%
01117,Alabama,Shelby County,200941,98189,102752,83684,86585,77588,81643,159231,41710,No,20.76%,23165,12%,11975,5.96%
01119,Alabama,Sumter County,13427,6079,7348,1583,1735,1530,1707,3237,10190,Yes,75.89%,9988,74%,136,1.01%
01121,Alabama,Talladega County,81762,39718,42044,26319,27383,25431,26878,52309,29453,No,36.02%,26294,32%,1756,2.15%
01123,Alabama,Tallapoosa County,41168,19957,21211,14466,14840,14002,14486,28488,12680,No,30.80%,11053,27%,1074,2.61%
01125,Alabama,Tuscaloosa County,198596,96162,102434,65926,67024,62817,64633,127450,71146,No,35.82%,60150,30%,6351,3.20%
01127,Alabama,Walker County,66221,32216,34005,29541,31185,28873,30658,59531,6690,No,10.10%,4095,6%,1427,2.15%
01129,Alabama,Washington County,17109,8396,8713,5672,5700,5607,5633,11240,5869,No,34.30%,4176,24%,201,1.17%
01131,Alabama,Wilcox County,11431,5382,6049,1533,1603,1520,1587,3107,8324,Yes,72.82%,8205,72%,83,0.73%
01133,Alabama,Winston County,24108,11832,12276,11416,11878,11150,11638,22788,1320,No,5.48%,189,1%,651,2.70%
02013,Alaska,Aleutians East Borough,3161,2147,1014,574,195,284,128,412,2749,Yes,86.97%,236,7%,414,13.10%
02016,Alaska,Aleutians West Census Area,5547,3734,1813,1621,655,1151,505,1656,3891,Yes,70.15%,377,7%,801,14.44%
02020,Alaska,Anchorage Municipality,298610,152114,146496,104020,95947,95148,87469,182617,115993,No,38.84%,18441,6%,24593,8.24%
02050,Alaska,Bethel Census Area,17746,9187,8559,1197,997,1140,942,2082,15664,Yes,88.27%,116,1%,248,1.40%
02060,Alaska,Bristol Bay Borough,991,540,451,285,189,277,180,457,534,Yes,53.88%,2,0%,30,3.03%
02068,Alaska,Denali Borough,1875,1028,847,934,752,910,726,1636,239,No,12.75%,17,1%,60,3.20%
02070,Alaska,Dillingham Census Area,5034,2600,2434,517,424,494,409,903,4131,Yes,82.06%,15,0%,112,2.22%
02090,Alaska,Fairbanks North Star Borough,100272,53348,46924,42033,35904,39200,33508,72708,27564,No,27.49%,5307,5%,6790,6.77%
02100,Alaska,Haines Borough,2552,1307,1245,1093,1031,1068,1020,2088,464,No,18.18%,14,1%,55,2.16%
02105,Alaska,Hoonah-Angoon Census Area,2129,1141,988,555,489,543,477,1020,1109,Yes,52.09%,10,0%,73,3.43%
02110,Alaska,Juneau City and Borough,32556,16555,16001,11828,11157,11177,10515,21692,10864,No,33.37%,427,1%,1888,5.80%
19093,Iowa,Ida County,7108,3545,3563,3487,3509,3425,3448,6873,235,No,3.31%,22,0%,129,1.81%
02122,Alaska,Kenai Peninsula Borough,56900,29736,27164,25321,23001,24579,22245,46824,10076,No,17.71%,415,1%,1906,3.35%
02130,Alaska,Ketchikan Gateway Borough,13779,7111,6668,4908,4429,4687,4244,8931,4848,No,35.18%,123,1%,630,4.57%
02150,Alaska,Kodiak Island Borough,14239,7644,6595,4527,3674,4083,3302,7385,6854,No,48.14%,196,1%,1131,7.94%
02164,Alaska,Lake and Peninsula Borough,1654,887,767,227,156,220,147,367,1287,Yes,77.81%,13,1%,42,2.54%
02170,Alaska,Matanuska-Susitna Borough,93925,48536,45389,41466,38221,40016,36716,76732,17193,No,18.31%,1097,1%,3859,4.11%
02180,Alaska,Nome Census Area,9915,5266,4649,994,753,960,726,1686,8229,Yes,83.00%,51,1%,137,1.38%
02185,Alaska,North Slope Borough,9643,6013,3630,2619,674,2513,627,3140,6503,Yes,67.44%,117,1%,284,2.95%
02188,Alaska,Northwest Arctic Borough,7810,4197,3613,574,371,545,350,895,6915,Yes,88.54%,56,1%,88,1.13%
02195,Alaska,Petersburg Census Area,3844,1988,1856,1429,1299,1353,1234,2587,1257,No,32.70%,25,1%,185,4.81%
02198,Alaska,Prince of Wales-Hyder Census Area,5751,3131,2620,1623,1240,1571,1205,2776,2975,Yes,51.73%,21,0%,163,2.83%
02220,Alaska,Sitka City and Borough,9046,4542,4504,3087,2979,2936,2841,5777,3269,No,36.14%,77,1%,494,5.46%
02230,Alaska,Skagway Municipality,959,497,462,458,415,440,402,842,117,No,12.20%,2,0%,35,3.65%
02240,Alaska,Southeast Fairbanks Census Area,7144,3965,3179,3243,2528,3125,2435,5560,1584,No,22.17%,97,1%,296,4.14%
02261,Alaska,Valdez-Cordova Census Area,9717,5165,4552,3881,3287,3737,3147,6884,2833,No,29.16%,81,1%,400,4.12%
02270,Alaska,Wade Hampton Census Area,7809,4099,3710,164,156,160,148,308,7501,Yes,96.06%,9,0%,21,0.27%
02275,Alaska,Wrangell City and Borough,2403,1246,1157,927,816,915,797,1712,691,No,28.76%,6,0%,41,1.71%
02282,Alaska,Yakutat City and Borough,668,366,302,150,118,140,115,255,413,Yes,61.83%,5,1%,17,2.54%
02290,Alaska,Yukon-Koyukuk Census Area,5770,3148,2622,757,561,732,544,1276,4494,Yes,77.89%,20,0%,76,1.32%
04001,Arizona,Apache County,73195,36300,36895,8888,8548,7224,7078,14302,58893,Yes,80.46%,448,1%,4503,6.15%
04003,Arizona,Cochise County,132088,67820,64268,59548,56624,39510,36436,75946,56142,No,42.50%,6324,5%,43718,33.10%
04005,Arizona,Coconino County,136011,67136,68875,45342,45321,37594,37578,75172,60839,No,44.73%,2024,1%,18572,13.65%
04007,Arizona,Gila County,53144,26434,26710,21566,21697,17060,17272,34332,18812,No,35.40%,356,1%,9757,18.36%
04009,Arizona,Graham County,37416,20000,17416,16296,14131,10046,9469,19515,17901,No,47.84%,782,2%,11715,31.31%
04011,Arizona,Greenlee County,8802,4611,4191,4265,3861,2233,1965,4198,4604,Yes,52.31%,124,1%,4166,47.33%
04012,Arizona,La Paz County,20281,10336,9945,8169,7683,6307,6058,12365,7916,No,39.03%,203,1%,5008,24.69%
04013,Arizona,Maricopa County,3942169,1950188,1991981,1659287,1691952,1121040,1161501,2282541,1659628,No,42.10%,218894,6%,1181994,29.98%
04015,Arizona,Mohave County,203334,102329,101005,94575,93356,80073,79972,160045,43289,No,21.29%,2507,1%,31352,15.42%
04017,Arizona,Navajo County,107094,53545,53549,28495,27108,23434,22887,46321,60773,Yes,56.75%,1163,1%,11639,10.87%
04019,Arizona,Pima County,992394,488415,503979,419056,434669,265079,274133,539212,453182,No,45.67%,39360,4%,351799,35.45%
04021,Arizona,Pinal County,387365,203338,184027,167225,155519,114577,111050,225627,161738,No,41.75%,18739,5%,112144,28.95%
04023,Arizona,Santa Cruz County,47303,22681,24622,21882,23817,3796,3736,7532,39771,Yes,84.08%,353,1%,39106,82.67%
04025,Arizona,Yavapai County,212637,103920,108717,97742,102213,84054,89281,173335,39302,No,18.48%,1630,1%,29580,13.91%
04027,Arizona,Yuma County,200022,101430,98592,92632,90677,35562,33033,68595,131427,Yes,65.71%,5078,3%,121053,60.52%
05001,Arkansas,Arkansas County,18892,9180,9712,6760,7013,6465,6841,13306,5586,No,29.57%,4717,25%,565,2.99%
05003,Arkansas,Ashley County,21524,10421,11103,7616,7849,7141,7450,14591,6933,No,32.21%,5586,26%,1116,5.18%
05005,Arkansas,Baxter County,41048,19741,21307,19169,20701,18838,20368,39206,1842,No,4.49%,99,0%,766,1.87%
05007,Arkansas,Benton County,232268,114908,117360,103647,106405,85943,89800,175743,56525,No,24.34%,4226,2%,36846,15.86%
05009,Arkansas,Boone County,37327,18349,18978,17702,18362,17303,18014,35317,2010,No,5.38%,145,0%,834,2.23%
05011,Arkansas,Bradley County,11397,5568,5829,3879,3957,3142,3390,6532,4865,No,42.69%,3125,27%,1587,13.92%
05013,Arkansas,Calhoun County,5307,2702,2605,2078,1940,1994,1878,3872,1435,No,27.04%,1179,22%,166,3.13%
05015,Arkansas,Carroll County,27610,13623,13987,12989,13315,11073,11639,22712,4898,No,17.74%,187,1%,3896,14.11%
05017,Arkansas,Chicot County,11433,5651,5782,2539,2417,2276,2227,4503,6930,Yes,60.61%,6286,55%,577,5.05%
05019,Arkansas,Clark County,22936,10908,12028,8199,8682,7775,8274,16049,6887,No,30.03%,5456,24%,985,4.29%
05021,Arkansas,Clay County,15684,7699,7985,7523,7823,7398,7729,15127,557,No,3.55%,75,0%,250,1.59%
05023,Arkansas,Cleburne County,25808,12738,13070,12381,12697,12095,12488,24583,1225,No,4.75%,103,0%,600,2.32%
05025,Arkansas,Cleveland County,8627,4213,4414,3664,3800,3598,3729,7327,1300,No,15.07%,1030,12%,154,1.79%
05027,Arkansas,Columbia County,24473,11729,12744,7320,7681,7073,7490,14563,9910,No,40.49%,8910,36%,595,2.43%
05029,Arkansas,Conway County,21287,10444,10843,8951,9228,8590,8869,17459,3828,No,17.98%,2419,11%,814,3.82%
05031,Arkansas,Craighead County,99735,48716,51019,40635,42121,38383,40335,78718,21017,No,21.07%,13757,14%,4563,4.58%
05033,Arkansas,Crawford County,61946,30501,31445,28037,28798,26250,27073,53323,8623,No,13.92%,923,1%,4026,6.50%
05035,Arkansas,Crittenden County,50021,23695,26326,11441,11874,10936,11488,22424,27597,Yes,55.17%,25617,51%,1142,2.28%
05037,Arkansas,Cross County,17683,8538,9145,6454,6808,6316,6695,13011,4672,No,26.42%,4073,23%,283,1.60%
05039,Arkansas,Dallas County,7987,3877,4110,2186,2265,2083,2188,4271,3716,No,46.53%,3378,42%,205,2.57%
05041,Arkansas,Desha County,12545,5891,6654,2989,3239,2774,3039,5813,6732,Yes,53.66%,6095,49%,577,4.60%
05043,Arkansas,Drew County,18743,9169,9574,6417,6626,6188,6410,12598,6145,No,32.79%,5307,28%,503,2.68%
05045,Arkansas,Faulkner County,118704,58126,60578,49856,51415,47539,49579,97118,21586,No,18.18%,12825,11%,4707,3.97%
05047,Arkansas,Franklin County,18045,8918,9127,8511,8703,8291,8496,16787,1258,No,6.97%,150,1%,466,2.58%
05049,Arkansas,Fulton County,12318,6036,6282,5860,6079,5800,6026,11826,492,No,3.99%,49,0%,133,1.08%
05051,Arkansas,Garland County,96903,46902,50001,41159,44090,38764,41999,80763,16140,No,16.66%,8121,8%,4969,5.13%
05053,Arkansas,Grant County,17986,8936,9050,8519,8640,8324,8481,16805,1181,No,6.57%,464,3%,439,2.44%
05055,Arkansas,Greene County,43163,21177,21986,20554,21359,20063,20874,40937,2226,No,5.16%,320,1%,1080,2.50%
05057,Arkansas,Hempstead County,22373,10852,11521,7466,7621,6152,6425,12577,9796,No,43.78%,6614,30%,2751,12.30%
05059,Arkansas,Hot Spring County,33394,17371,16023,14816,13897,14328,13505,27833,5561,No,16.65%,3795,11%,1002,3.00%
05061,Arkansas,Howard County,13735,6689,7046,5130,5265,4476,4641,9117,4618,No,33.62%,2926,21%,1403,10.21%
05063,Arkansas,Independence County,37025,18109,18916,17138,17911,16063,16975,33038,3987,No,10.77%,781,2%,2247,6.07%
05065,Arkansas,Izard County,13474,6938,6536,6592,6334,6460,6271,12731,743,No,5.51%,189,1%,218,1.62%
05067,Arkansas,Jackson County,17600,8717,8883,7010,7128,6769,6950,13719,3881,No,22.05%,3027,17%,476,2.70%
19111,Iowa,Lee County,35617,17966,17651,16718,16810,16115,16358,32473,3144,No,8.83%,1133,3%,1173,3.29%
05069,Arkansas,Jefferson County,74723,36577,38146,15890,15469,15369,15026,30395,44328,Yes,59.32%,41418,55%,1341,1.79%
05071,Arkansas,Johnson County,25901,12849,13052,12083,12311,10456,10840,21296,4605,No,17.78%,499,2%,3364,12.99%
05073,Arkansas,Lafayette County,7447,3594,3853,2237,2284,2183,2241,4424,3023,No,40.59%,2802,38%,138,1.85%
05075,Arkansas,Lawrence County,17012,8323,8689,8108,8468,8014,8396,16410,602,No,3.54%,143,1%,177,1.04%
05077,Arkansas,Lee County,10216,5671,4545,2573,1798,2466,1731,4197,6019,Yes,58.92%,5601,55%,228,2.23%
05079,Arkansas,Lincoln County,14101,8610,5491,5469,4118,5204,3980,9184,4917,No,34.87%,4248,30%,494,3.50%
05081,Arkansas,Little River County,12919,6306,6613,4847,4956,4668,4804,9472,3447,No,26.68%,2565,20%,405,3.13%
05083,Arkansas,Logan County,21983,10952,11031,10241,10388,9991,10165,20156,1827,No,8.31%,333,2%,556,2.53%
05085,Arkansas,Lonoke County,69839,34320,35519,31294,32038,30110,31015,61125,8714,No,12.48%,4193,6%,2529,3.62%
05087,Arkansas,Madison County,15645,7867,7778,7557,7447,7159,7117,14276,1369,No,8.75%,55,0%,830,5.31%
05089,Arkansas,Marion County,16568,8279,8289,8030,8023,7874,7886,15760,808,No,4.88%,62,0%,358,2.16%
05091,Arkansas,Miller County,43634,21441,22193,15820,15834,15285,15404,30689,12945,No,29.67%,10671,24%,1245,2.85%
05093,Arkansas,Mississippi County,45562,22146,23416,14303,14547,13484,13862,27346,18216,No,39.98%,15675,34%,1735,3.81%
05095,Arkansas,Monroe County,7828,3718,4110,2102,2322,2042,2277,4319,3509,No,44.83%,3215,41%,151,1.93%
05097,Arkansas,Montgomery County,9340,4649,4691,4445,4479,4299,4336,8635,705,No,7.55%,51,1%,352,3.77%
05099,Arkansas,Nevada County,8925,4370,4555,2928,3009,2794,2895,5689,3236,No,36.26%,2786,31%,288,3.23%
05101,Arkansas,Newton County,8086,4091,3995,3942,3815,3888,3766,7654,432,No,5.34%,17,0%,121,1.50%
05103,Arkansas,Ouachita County,25396,11943,13453,7052,7481,6858,7340,14198,11198,No,44.09%,10254,40%,440,1.73%
05105,Arkansas,Perry County,10339,5133,5206,4881,4983,4750,4877,9627,712,No,6.89%,205,2%,267,2.58%
05107,Arkansas,Phillips County,20784,9750,11034,3654,3798,3567,3724,7291,13493,Yes,64.92%,12992,63%,308,1.48%
05109,Arkansas,Pike County,11247,5604,5643,5216,5311,4885,4990,9875,1372,No,12.20%,369,3%,754,6.70%
05111,Arkansas,Poinsett County,24307,11811,12496,10705,11278,10407,11021,21428,2879,No,11.84%,1866,8%,632,2.60%
05113,Arkansas,Polk County,20471,10049,10422,9504,9920,8889,9368,18257,2214,No,10.82%,84,0%,1260,6.16%
05115,Arkansas,Pope County,62765,31189,31576,28776,29425,26536,27490,54026,8739,No,13.92%,1934,3%,4650,7.41%
05117,Arkansas,Prairie County,8458,4195,4263,3636,3651,3596,3621,7217,1241,No,14.67%,1059,13%,79,0.93%
05119,Arkansas,Pulaski County,388953,186936,202017,114257,117914,103083,109172,212255,176698,No,45.43%,138009,35%,23417,6.02%
05121,Arkansas,Randolph County,17930,8778,9152,8522,8882,8366,8769,17135,795,No,4.43%,153,1%,301,1.68%
05123,Arkansas,St. Francis County,27858,15216,12642,7170,5365,6365,5246,11611,16247,Yes,58.32%,14591,52%,1195,4.29%
05125,Arkansas,Saline County,111845,55083,56762,50543,51808,48294,49892,98186,13659,No,12.21%,6247,6%,4584,4.10%
05127,Arkansas,Scott County,11010,5572,5438,5100,4934,4702,4642,9344,1666,No,15.13%,73,1%,774,7.03%
05129,Arkansas,Searcy County,8007,4004,4003,3842,3834,3760,3786,7546,461,No,5.76%,25,0%,154,1.92%
05131,Arkansas,Sebastian County,127304,62458,64846,52053,54075,44587,47184,91771,35533,No,27.91%,8519,7%,16187,12.72%
05133,Arkansas,Sevier County,17177,8539,8638,7700,7667,4997,5236,10233,6944,No,40.43%,782,5%,5520,32.14%
05135,Arkansas,Sharp County,17054,8417,8637,8088,8315,7963,8162,16125,929,No,5.45%,125,1%,305,1.79%
05137,Arkansas,Stone County,12663,6246,6417,6029,6255,5941,6172,12113,550,No,4.34%,29,0%,188,1.48%
05139,Arkansas,Union County,40867,19859,21008,13049,13308,12379,12770,25149,15718,No,38.46%,13473,33%,1452,3.55%
05141,Arkansas,Van Buren County,17030,8525,8505,8220,8197,7986,8005,15991,1039,No,6.10%,85,0%,475,2.79%
05143,Arkansas,Washington County,211411,105602,105809,92888,93532,76201,78397,154598,56813,No,26.87%,6868,3%,34042,16.10%
05145,Arkansas,White County,78493,38464,40029,35543,37138,33996,35891,69887,8606,No,10.96%,3361,4%,3100,3.95%
05147,Arkansas,Woodruff County,7100,3386,3714,2405,2587,2356,2554,4910,2190,No,30.85%,1946,27%,102,1.44%
05149,Arkansas,Yell County,21932,10936,10996,10293,10380,8180,8453,16633,5299,No,24.16%,402,2%,4254,19.40%
06001,California,Alameda County,1554720,762520,792200,407938,405572,258244,262785,521029,1033691,Yes,66.49%,198719,13%,352707,22.69%
06003,California,Alpine County,1129,593,536,443,383,414,359,773,356,No,31.53%,5,0%,95,8.41%
06005,California,Amador County,37035,19898,17137,17806,15866,15232,14390,29622,7413,No,20.02%,868,2%,4691,12.67%
06007,California,Butte County,221539,109845,111694,95317,97500,80880,83885,164765,56774,No,25.63%,3816,2%,32875,14.84%
06009,California,Calaveras County,44742,22383,22359,20600,20639,18439,18679,37118,7624,No,17.04%,443,1%,4823,10.78%
06011,California,Colusa County,21411,11046,10365,10173,9481,4101,4111,8212,13199,Yes,61.65%,249,1%,12113,56.57%
06013,California,Contra Costa County,1079597,526925,552672,364406,372460,247731,258027,505758,573839,Yes,53.15%,104138,10%,267419,24.77%
06015,California,Del Norte County,28290,15670,12620,12198,10178,9126,8913,18039,10251,No,36.24%,1080,4%,5311,18.77%
06017,California,El Dorado County,180561,90306,90255,81812,81397,71969,71771,143740,36821,No,20.39%,1623,1%,22083,12.23%
19161,Iowa,Sac County,10153,4977,5176,4897,5083,4786,4990,9776,377,No,3.71%,35,0%,233,2.29%
06019,California,Fresno County,947895,473456,474439,367392,366951,146956,155176,302132,645763,Yes,68.13%,55960,6%,485394,51.21%
06021,California,Glenn County,27992,14130,13862,12738,12509,7571,7757,15328,12664,No,45.24%,301,1%,10826,38.68%
06023,California,Humboldt County,134827,67538,67289,57114,56754,51562,51540,103102,31725,No,23.53%,1788,1%,13831,10.26%
06025,California,Imperial County,176948,90891,86057,80141,78175,12682,10579,23261,153687,Yes,86.85%,6463,4%,143739,81.23%
06027,California,Inyo County,18495,9293,9202,7636,7501,6059,5967,12026,6469,No,34.98%,151,1%,3759,20.32%
06029,California,Kern County,856158,439580,416578,365114,345087,161670,159881,321551,534607,Yes,62.44%,53833,6%,430807,50.32%
06031,California,Kings County,151364,84597,66767,67969,55237,28709,23826,52535,98829,Yes,65.29%,11412,8%,78765,52.04%
06033,California,Lake County,63983,32109,31874,28240,28128,23331,23611,46942,17041,No,26.63%,1285,2%,11521,18.01%
06035,California,Lassen County,33658,21635,12023,16881,10536,12789,9448,22237,11421,No,33.93%,3013,9%,6111,18.16%
06037,California,Los Angeles County,9962789,4914006,5048783,3571798,3560611,1367211,1355624,2722835,7239954,Yes,72.67%,923555,9%,4802133,48.20%
06039,California,Madera County,152218,74022,78196,64679,66764,26825,29573,56398,95820,Yes,62.95%,6238,4%,84062,55.22%
06041,California,Marin County,256069,125372,130697,107955,112944,89683,96611,186294,69775,No,27.25%,7412,3%,40121,15.67%
06043,California,Mariposa County,17905,9121,8784,8239,7977,7492,7284,14776,3129,No,17.48%,183,1%,1703,9.51%
06045,California,Mendocino County,87428,43602,43826,37975,37970,29109,30029,59138,28290,No,32.36%,818,1%,20140,23.04%
06047,California,Merced County,262305,132417,129888,108342,106364,39656,40953,80609,181696,Yes,69.27%,11199,4%,147211,56.12%
06049,California,Modoc County,9327,4704,4623,4173,4122,3631,3623,7254,2073,No,22.23%,101,1%,1346,14.43%
06051,California,Mono County,14348,7729,6619,7143,6094,5194,4390,9584,4764,No,33.20%,96,1%,3906,27.22%
06053,California,Monterey County,426762,219443,207319,180887,170848,67968,68475,136443,290319,Yes,68.03%,15648,4%,240870,56.44%
06055,California,Napa County,139045,69338,69707,59540,59535,37339,39401,76740,62305,No,44.81%,3138,2%,46015,33.09%
06057,California,Nevada County,98292,48531,49761,45659,46689,41682,42999,84681,13611,No,13.85%,481,0%,8789,8.94%
06059,California,Orange County,3090132,1528718,1561414,1147011,1153697,657354,672989,1330343,1759789,Yes,56.95%,63299,2%,1055225,34.15%
06061,California,Placer County,361682,176673,185009,153473,160068,132581,139282,271863,89819,No,24.83%,5765,2%,48002,13.27%
06063,California,Plumas County,19399,9708,9691,8862,8849,8155,8239,16394,3005,No,15.49%,188,1%,1599,8.24%
06065,California,Riverside County,2268783,1130165,1138618,917296,916683,433500,441074,874574,1394209,Yes,61.45%,158919,7%,1055510,46.52%
06067,California,Sacramento County,1450121,710199,739922,465877,481145,336149,355371,691520,758601,Yes,52.31%,157728,11%,319529,22.03%
06069,California,San Benito County,56884,28483,28401,25286,25180,10537,10664,21201,35683,Yes,62.73%,731,1%,32614,57.33%
06071,California,San Bernardino County,2081313,1036274,1045039,809679,805707,333189,333224,666413,1414900,Yes,67.98%,200072,10%,1050372,50.47%
06073,California,San Diego County,3177063,1596752,1580311,1232296,1204634,773481,739832,1513313,1663750,Yes,52.37%,177261,6%,1037685,32.66%
06075,California,San Francisco County,825863,420224,405639,240133,208238,184611,159446,344057,481806,Yes,58.34%,50335,6%,126876,15.36%
06077,California,San Joaquin County,702612,349916,352696,240915,239743,120620,125322,245942,456670,Yes,65.00%,57448,8%,279104,39.72%
06079,California,San Luis Obispo County,274804,140493,134311,123921,121157,96195,96742,192937,81867,No,29.79%,6291,2%,58998,21.47%
06081,California,San Mateo County,739311,363870,375441,235968,235696,152875,154434,307309,432002,Yes,58.43%,22949,3%,187658,25.38%
06083,California,Santa Barbara County,431249,216752,214497,186664,184849,99208,103113,202321,228928,Yes,53.08%,10301,2%,188772,43.77%
06085,California,Santa Clara County,1837504,923522,913982,539383,519472,320452,309788,630240,1207264,Yes,65.70%,53405,3%,494226,26.90%
06087,California,Santa Cruz County,266776,132819,133957,117147,117621,77829,79264,157093,109683,No,41.11%,3765,1%,87299,32.72%
06089,California,Shasta County,178586,87619,90967,77763,81010,71314,74688,146002,32584,No,18.25%,1733,1%,15849,8.87%
06091,California,Sierra County,3086,1549,1537,1456,1469,1336,1349,2685,401,No,12.99%,12,0%,270,8.75%
06093,California,Siskiyou County,44154,21970,22184,19252,19464,17179,17511,34690,9464,No,21.43%,643,1%,4915,11.13%
06095,California,Solano County,420757,209949,210808,129180,125840,85005,84647,169652,251105,Yes,59.68%,63226,15%,104203,24.77%
06097,California,Sonoma County,491829,241669,250160,212104,219163,155052,166724,321776,170053,No,34.58%,9231,2%,125660,25.55%
06099,California,Stanislaus County,521726,258268,263458,218133,222451,115429,122712,238141,283585,Yes,54.36%,16926,3%,224498,43.03%
06101,California,Sutter County,95022,47282,47740,35223,35792,22554,24018,46572,48450,Yes,50.99%,2267,2%,27878,29.34%
06103,California,Tehama County,63406,31583,31823,28857,29013,22174,22845,45019,18387,No,29.00%,533,1%,14500,22.87%
06105,California,Trinity County,13526,6991,6535,6194,5822,5821,5477,11298,2228,No,16.47%,66,0%,948,7.01%
06107,California,Tulare County,451977,226904,225073,200734,198777,68895,73169,142064,309913,Yes,68.57%,10053,2%,279394,61.82%
06109,California,Tuolumne County,54008,28323,25685,25481,23706,22279,21860,44139,9869,No,18.27%,1165,2%,5978,11.07%
06111,California,Ventura County,835981,414976,421005,354879,357237,195939,202683,398622,437359,Yes,52.32%,18543,2%,344470,41.21%
06113,California,Yolo County,204118,99317,104801,75871,79639,48177,51929,100106,104012,Yes,50.96%,6067,3%,63340,31.03%
06115,California,Yuba County,72926,36896,36030,29422,28664,21215,20919,42134,30792,No,42.22%,2778,4%,19128,26.23%
08001,Colorado,Adams County,459598,231194,228404,202064,199753,120376,121940,242316,217282,No,47.28%,16013,3%,176496,38.40%
08003,Colorado,Alamosa County,16148,8082,8066,7139,7188,4010,4057,8067,8081,Yes,50.04%,265,2%,7322,45.34%
08005,Colorado,Arapahoe County,595546,292706,302840,231933,239180,183288,192099,375387,220159,No,36.97%,63427,11%,110700,18.59%
08007,Colorado,Archuleta County,12070,6056,6014,5673,5624,4730,4695,9425,2645,No,21.91%,46,0%,2165,17.94%
08009,Colorado,Baca County,3751,1852,1899,1774,1816,1607,1672,3279,472,No,12.58%,36,1%,351,9.36%
08011,Colorado,Bent County,5773,3656,2117,3066,1982,1987,1438,3425,2348,No,40.67%,389,7%,1807,31.30%
08013,Colorado,Boulder County,305318,153380,151938,140021,138567,121147,119948,241095,64223,No,21.03%,3166,1%,41361,13.55%
08014,Colorado,Broomfield County,58298,28969,29329,25796,26083,22606,22912,45518,12780,No,21.92%,833,1%,7126,12.22%
08015,Colorado,Chaffee County,18150,9658,8492,9038,8166,7998,7575,15573,2577,No,14.20%,303,2%,1819,10.02%
08017,Colorado,Cheyenne County,1874,942,932,911,905,811,806,1617,257,No,13.71%,8,0%,209,11.15%
08019,Colorado,Clear Creek County,9026,4675,4351,4486,4157,4278,3951,8229,797,No,8.83%,68,1%,486,5.38%
08021,Colorado,Conejos County,8275,4102,4173,3825,3890,1754,1824,3578,4697,Yes,56.76%,51,1%,4515,54.56%
08023,Colorado,Costilla County,3594,1872,1722,1671,1546,594,562,1156,2438,Yes,67.84%,52,1%,2325,64.69%
08025,Colorado,Crowley County,5365,3751,1614,3057,1494,1935,1146,3081,2284,No,42.57%,484,9%,1599,29.80%
08027,Colorado,Custer County,4249,2177,2072,2087,2004,1965,1936,3901,348,No,8.19%,46,1%,217,5.11%
08029,Colorado,Delta County,30432,15311,15121,14532,14499,12441,12656,25097,5335,No,17.53%,212,1%,4387,14.42%
08031,Colorado,Denver County,634265,317515,316750,257547,253730,166894,167614,334508,299757,No,47.26%,65854,10%,199865,31.51%
08033,Colorado,Dolores County,1994,1024,970,963,907,930,859,1789,205,No,10.28%,7,0%,86,4.31%
08035,Colorado,Douglas County,298215,147857,150358,136087,137948,125545,127056,252601,45614,No,15.30%,3941,1%,23721,7.95%
08037,Colorado,Eagle County,51874,27564,24310,26305,23163,18472,16277,34749,17125,No,33.01%,495,1%,15700,30.27%
08039,Colorado,Elbert County,23383,11771,11612,11305,11133,10681,10483,21164,2219,No,9.49%,159,1%,1410,6.03%
08041,Colorado,El Paso County,644964,323355,321609,272300,269954,230536,229093,459629,185335,No,28.74%,43626,7%,100691,15.61%
08043,Colorado,Fremont County,46788,26933,19855,23991,19005,20004,17482,37486,9302,No,19.88%,1834,4%,5911,12.63%
08045,Colorado,Garfield County,56953,29264,27689,27605,26151,19893,19198,39091,17862,No,31.36%,656,1%,16195,28.44%
08047,Colorado,Gilpin County,5491,2871,2620,2727,2478,2588,2329,4917,574,No,10.45%,41,1%,329,5.99%
08049,Colorado,Grand County,14195,7584,6611,7295,6334,6808,5881,12689,1506,No,10.61%,75,1%,1079,7.60%
08051,Colorado,Gunnison County,15475,8348,7127,7903,6764,7333,6305,13638,1837,No,11.87%,68,0%,1393,9.00%
08053,Colorado,Hinsdale County,810,420,390,400,378,387,361,748,62,No,7.65%,4,0%,33,4.07%
08055,Colorado,Huerfano County,6596,3298,3298,2962,2985,1989,2040,4029,2567,No,38.92%,51,1%,2338,35.45%
08057,Colorado,Jackson County,1348,711,637,681,621,599,564,1163,185,No,13.72%,2,0%,157,11.65%
08059,Colorado,Jefferson County,545358,271017,274341,250401,253449,214902,217123,432025,113333,No,20.78%,6879,1%,81279,14.90%
08061,Colorado,Kiowa County,1444,714,730,691,710,653,680,1333,111,No,7.69%,7,0%,85,5.89%
08063,Colorado,Kit Carson County,8094,4441,3653,4144,3526,3275,2982,6257,1837,No,22.70%,174,2%,1497,18.50%
08065,Colorado,Lake County,7338,3938,3400,3707,3210,2277,1952,4229,3109,No,42.37%,45,1%,2913,39.70%
08067,Colorado,La Plata County,52401,26678,25723,24025,22962,21384,20422,41806,10595,No,20.22%,276,1%,6442,12.29%
08069,Colorado,Larimer County,310487,154250,156237,144249,146195,129243,131766,261009,49478,No,15.94%,3072,1%,33597,10.82%
08071,Colorado,Las Animas County,14945,7655,7290,6949,6764,4046,3888,7934,7011,No,46.91%,226,2%,6359,42.55%
08073,Colorado,Lincoln County,5453,3202,2251,2815,2149,2308,1981,4289,1164,No,21.35%,297,5%,732,13.42%
08075,Colorado,Logan County,22631,12881,9750,11538,9327,9272,8207,17479,5152,No,22.77%,958,4%,3690,16.31%
08077,Colorado,Mesa County,147848,73593,74255,69452,70112,60421,61640,122061,25787,No,17.44%,1268,1%,20225,13.68%
08079,Colorado,Mineral County,709,361,348,352,342,343,331,674,35,No,4.94%,2,0%,20,2.82%
08081,Colorado,Moffat County,13200,6808,6392,6540,6121,5622,5304,10926,2274,No,17.23%,48,0%,1871,14.17%
08083,Colorado,Montezuma County,25431,12665,12766,10731,10670,9420,9434,18854,6577,No,25.86%,89,0%,3023,11.89%
08085,Colorado,Montrose County,40725,20062,20663,18967,19594,15235,16130,31365,9360,No,22.98%,258,1%,8163,20.04%
08087,Colorado,Morgan County,28472,14146,14326,13109,13321,8381,8928,17309,11163,No,39.21%,937,3%,9794,34.40%
08089,Colorado,Otero County,18698,9217,9481,8456,8761,5079,5364,10443,8255,No,44.15%,198,1%,7646,40.89%
08091,Colorado,Ouray County,4530,2233,2297,2174,2226,2071,2120,4191,339,No,7.48%,8,0%,227,5.01%
08093,Colorado,Park County,16029,8431,7598,8055,7223,7707,6903,14610,1419,No,8.85%,83,1%,797,4.97%
08095,Colorado,Phillips County,4367,2141,2226,2073,2157,1661,1768,3429,938,No,21.48%,32,1%,835,19.12%
08097,Colorado,Pitkin County,17263,9146,8117,8821,7777,8005,7053,15058,2205,No,12.77%,117,1%,1649,9.55%
08099,Colorado,Prowers County,12389,6178,6211,5902,5958,3710,3961,7671,4718,No,38.08%,93,1%,4418,35.66%
08101,Colorado,Pueblo County,160852,79184,81668,71823,74691,42016,44062,86078,74774,No,46.49%,3889,2%,67578,42.01%
08103,Colorado,Rio Blanco County,6857,3568,3289,3295,3123,2939,2822,5761,1096,No,15.98%,69,1%,801,11.68%
08105,Colorado,Rio Grande County,11943,5955,5988,5585,5639,3180,3216,6396,5547,No,46.45%,71,1%,5235,43.83%
08107,Colorado,Routt County,23334,12338,10996,11948,10614,11218,9937,21155,2179,No,9.34%,105,0%,1590,6.81%
08109,Colorado,Saguache County,6304,3181,3123,2964,2912,1840,1737,3577,2727,No,43.26%,36,1%,2486,39.44%
08111,Colorado,San Juan County,690,403,287,385,278,336,241,577,113,No,16.38%,0,0%,94,13.62%
08113,Colorado,San Miguel County,7580,4069,3511,3905,3360,3562,3084,6646,934,No,12.32%,43,1%,712,9.39%
08115,Colorado,Sedgwick County,2383,1208,1175,1157,1130,995,983,1978,405,No,17.00%,11,0%,334,14.02%
08117,Colorado,Summit County,28044,15325,12719,14699,12238,12743,10530,23273,4771,No,17.01%,267,1%,3943,14.06%
08119,Colorado,Teller County,23389,11915,11474,11348,10901,10771,10328,21099,2290,No,9.79%,148,1%,1352,5.78%
08121,Colorado,Washington County,4766,2449,2317,2370,2262,2137,2068,4205,561,No,11.77%,34,1%,446,9.36%
08123,Colorado,Weld County,263691,132406,131285,123215,123064,88126,89494,177620,86071,No,32.64%,3408,1%,74969,28.43%
08125,Colorado,Yuma County,10119,5049,5070,4912,4950,3817,4008,7825,2294,No,22.67%,30,0%,2149,21.24%
09001,Connecticut,Fairfield County,933835,455031,478804,369268,383027,296516,313222,609738,324097,No,34.71%,110864,12%,166186,17.80%
09003,Connecticut,Hartford County,897259,434525,462734,338108,359551,281927,301097,583024,314235,No,35.02%,133107,15%,145127,16.17%
09005,Connecticut,Litchfield County,187530,92275,95255,87373,90388,83554,86589,170143,17387,No,9.27%,3146,2%,9210,4.91%
09007,Connecticut,Middlesex County,165602,80769,84833,72799,76218,69192,72655,141847,23755,No,14.34%,8541,5%,8624,5.21%
09009,Connecticut,New Haven County,862813,416041,446772,332646,354052,276209,297614,573823,288990,No,33.49%,119601,14%,137422,15.93%
09011,Connecticut,New London County,274170,136944,137226,115373,116476,105427,107270,212697,61473,No,22.42%,17769,6%,25167,9.18%
09013,Connecticut,Tolland County,151539,76034,75505,68636,68969,65614,66336,131950,19589,No,12.93%,5188,3%,6987,4.61%
09015,Connecticut,Windham County,117599,58297,59302,54058,55393,49067,50581,99648,17951,No,15.26%,3280,3%,11922,10.14%
10001,Delaware,Kent County,167626,80748,86878,56420,58978,52571,55165,107736,59890,No,35.73%,41703,25%,10670,6.37%
10003,Delaware,New Castle County,546076,264590,281486,181680,189615,160731,170676,331407,214669,No,39.31%,134069,25%,49665,9.09%
10005,Delaware,Sussex County,203390,99020,104370,81734,85925,73735,79136,152871,50519,No,24.84%,26318,13%,18478,9.09%
11001,District of Columbia,District of Columbia,632323,299041,333282,135576,135747,111213,113114,224327,407996,Yes,64.52%,316482,50%,62726,9.92%
12001,Florida,Alachua County,251417,121680,129737,87661,91505,78087,81554,159641,91776,No,36.50%,51115,20%,22151,8.81%
12003,Florida,Baker County,27086,14138,12948,11569,11213,11270,10978,22248,4838,No,17.86%,3617,13%,628,2.32%
12005,Florida,Bay County,171903,84984,86919,70873,71628,67031,68034,135065,36838,No,21.43%,19161,11%,8856,5.15%
12007,Florida,Bradford County,27049,14696,12353,11066,10052,10484,9796,20280,6769,No,25.02%,5259,19%,965,3.57%
12009,Florida,Brevard County,547307,267595,279712,226727,234376,206725,213502,420227,127080,No,23.22%,57500,11%,47892,8.75%
12011,Florida,Broward County,1815137,881656,933481,592999,606523,379874,380877,760751,1054386,Yes,58.09%,506874,28%,480524,26.47%
12013,Florida,Calhoun County,14723,8015,6708,6339,5766,5842,5573,11415,3308,No,22.47%,2013,14%,790,5.37%
12015,Florida,Charlotte County,162449,79020,83429,71638,75855,66990,71182,138172,24277,No,14.94%,9917,6%,10638,6.55%
12017,Florida,Citrus County,139360,67351,72009,63105,67341,60014,64307,124321,15039,No,10.79%,4204,3%,6834,4.90%
12019,Florida,Clay County,194345,95154,99191,79723,81916,72941,75059,148000,46345,No,23.85%,20137,10%,16279,8.38%
12021,Florida,Collier County,332427,163637,168790,147223,151859,103616,112561,216177,116250,No,34.97%,23527,7%,87123,26.21%
12023,Florida,Columbia County,67966,35218,32748,27011,26042,25279,24689,49968,17998,No,26.48%,12527,18%,3520,5.18%
12027,Florida,DeSoto County,34712,19562,15150,16032,12926,9778,9429,19207,15505,No,44.67%,4688,14%,10507,30.27%
12029,Florida,Dixie County,16126,8671,7455,7510,6829,7190,6610,13800,2326,No,14.42%,1431,9%,590,3.66%
12031,Florida,Duval County,879602,426602,453000,272227,277828,242704,249326,492030,387572,No,44.06%,262849,30%,71665,8.15%
12033,Florida,Escambia County,302715,149931,152784,107104,105159,100060,99667,199727,102988,No,34.02%,69289,23%,15488,5.12%
12035,Florida,Flagler County,98359,47175,51184,39798,42771,36001,38672,74673,23686,No,24.08%,11321,12%,9078,9.23%
12037,Florida,Franklin County,11686,6732,4954,5325,4384,4937,4246,9183,2503,No,21.42%,1650,14%,579,4.95%
12039,Florida,Gadsden County,46528,23261,23267,10386,9375,8161,7361,15522,31006,Yes,66.64%,25668,55%,4871,10.47%
12041,Florida,Gilchrist County,16815,8798,8017,7917,7543,7483,7229,14712,2103,No,12.51%,950,6%,838,4.98%
12043,Florida,Glades County,13107,7489,5618,5793,4687,4297,3701,7998,5109,No,38.98%,1729,13%,2817,21.49%
12045,Florida,Gulf County,15718,9433,6285,6955,5334,6404,5206,11610,4108,No,26.14%,3004,19%,730,4.64%
12047,Florida,Hamilton County,14708,8646,6062,5229,3948,4497,3551,8048,6660,No,45.28%,5049,34%,1333,9.06%
12049,Florida,Hardee County,27514,14728,12786,13013,11379,6679,6411,13090,14424,Yes,52.42%,2063,7%,11847,43.06%
12051,Florida,Hendry County,37447,19771,17676,16363,14331,6458,6603,13061,24386,Yes,65.12%,5100,14%,18587,49.64%
12053,Florida,Hernando County,173422,82943,90479,75551,82311,67246,73523,140769,32653,No,18.83%,9582,6%,18959,10.93%
12055,Florida,Highlands County,98128,47819,50309,41150,43280,32515,35643,68158,29970,No,30.54%,9997,10%,17794,18.13%
12057,Florida,Hillsborough County,1277746,623888,653858,477383,491366,332242,344458,676700,601046,No,47.04%,221976,17%,326741,25.57%
12059,Florida,Holmes County,19804,10575,9229,9177,8652,8866,8482,17348,2456,No,12.40%,1277,6%,537,2.71%
12061,Florida,Indian River County,140567,67813,72754,59306,63814,51340,56569,107909,32658,No,23.23%,12984,9%,16433,11.69%
12063,Florida,Jackson County,48968,27019,21949,18291,15885,16896,15336,32232,16736,No,34.18%,13274,27%,2301,4.70%
12065,Florida,Jefferson County,14256,7413,6843,4585,4204,4302,4032,8334,5922,No,41.54%,5108,36%,557,3.91%
12067,Florida,Lafayette County,8804,5309,3495,4064,3191,3393,2852,6245,2559,No,29.07%,1363,15%,1088,12.36%
12069,Florida,Lake County,303186,146692,156494,124908,132706,107651,115206,222857,80329,No,26.49%,31736,10%,39299,12.96%
12071,Florida,Lee County,645293,316506,328787,276990,286563,219852,232460,452312,192981,No,29.91%,57810,9%,122085,18.92%
12073,Florida,Leon County,283769,134982,148787,87384,92273,80068,84700,164768,119001,No,41.94%,88587,31%,17730,6.25%
12075,Florida,Levy County,40025,19763,20262,17293,17635,15777,16367,32144,7881,No,19.69%,3895,10%,3088,7.72%
12077,Florida,Liberty County,8276,5114,3162,3710,2722,3335,2600,5935,2341,No,28.29%,1573,19%,587,7.09%
12079,Florida,Madison County,18907,9951,8956,5846,5214,5313,4967,10280,8627,No,45.63%,7419,39%,918,4.86%
12081,Florida,Manatee County,333895,161558,172337,140474,148772,116198,126425,242623,91272,No,27.34%,31212,9%,50928,15.25%
12083,Florida,Marion County,335125,160795,174330,134335,144632,117065,127692,244757,90368,No,26.97%,43691,13%,38317,11.43%
12085,Florida,Martin County,148817,73672,75145,66150,68658,57259,61279,118538,30279,No,20.35%,8613,6%,18837,12.66%
12086,Florida,Miami-Dade County,2591035,1258195,1332840,980926,1029458,215968,206525,422493,2168542,Yes,83.69%,496932,19%,1666528,64.32%
12087,Florida,Monroe County,74809,39615,35194,35865,31602,27823,24460,52283,22526,No,30.11%,4759,6%,16025,21.42%
12089,Florida,Nassau County,74629,36759,37870,33331,34139,32154,33019,65173,9456,No,12.67%,4939,7%,2696,3.61%
12091,Florida,Okaloosa County,190083,96162,93921,79638,76822,72859,70768,143627,46456,No,24.44%,18678,10%,15378,8.09%
12093,Florida,Okeechobee County,39467,21108,18359,18039,16378,12639,12499,25138,14329,No,36.31%,3569,9%,9825,24.89%
12095,Florida,Orange County,1202234,591772,610462,417799,420992,270301,268776,539077,663157,Yes,55.16%,262499,22%,339202,28.21%
12097,Florida,Osceola County,287416,141564,145852,114009,117273,54566,55319,109885,177531,Yes,61.77%,37298,13%,137251,47.75%
12099,Florida,Palm Beach County,1356545,657259,699286,506279,536609,381856,414381,796237,560308,No,41.30%,246973,18%,272389,20.08%
12101,Florida,Pasco County,470391,228769,241622,206102,217861,179684,190905,370589,99802,No,21.22%,24545,5%,59063,12.56%
12103,Florida,Pinellas County,921319,442316,479003,371018,399448,336669,364635,701304,220015,No,23.88%,99137,11%,78368,8.51%
12105,Florida,Polk County,616158,302111,314047,242101,250962,189363,200983,390346,225812,No,36.65%,95980,16%,114459,18.58%
12107,Florida,Putnam County,73263,36223,37040,29304,29567,26040,26600,52640,20623,No,28.15%,12227,17%,6940,9.47%
12109,Florida,St. Johns County,202188,98266,103922,88389,93347,83378,88004,171382,30806,No,15.24%,11594,6%,11477,5.68%
12111,Florida,St. Lucie County,283866,138389,145477,105632,109439,83480,88059,171539,112327,No,39.57%,56369,20%,48651,17.14%
12113,Florida,Santa Rosa County,158512,80845,77667,69844,68871,66417,65797,132214,26298,No,16.59%,10273,6%,7776,4.91%
12115,Florida,Sarasota County,386147,184305,201842,169301,185348,154181,170816,324997,61150,No,15.84%,19243,5%,32570,8.43%
12117,Florida,Seminole County,430838,208591,222247,170609,180266,136858,143894,280752,150086,No,34.84%,50770,12%,78569,18.24%
12119,Florida,Sumter County,101620,52205,49415,44774,45603,41509,43648,85157,16463,No,16.20%,9156,9%,5870,5.78%
12121,Florida,Suwannee County,43656,22891,20765,18872,17728,16761,16215,32976,10680,No,24.46%,5850,13%,3996,9.15%
12123,Florida,Taylor County,22744,12846,9898,9409,7835,8766,7675,16441,6303,No,27.71%,4767,21%,898,3.95%
12125,Florida,Union County,15212,9858,5354,6906,4546,6408,4362,10770,4442,No,29.20%,3455,23%,790,5.19%
12127,Florida,Volusia County,496950,242099,254851,206263,216033,180519,189721,370240,126710,No,25.50%,54706,11%,58790,11.83%
12129,Florida,Wakulla County,30818,16874,13944,13328,12011,12737,11656,24393,6425,No,20.85%,4545,15%,1121,3.64%
12131,Florida,Walton County,57582,29419,28163,26091,25485,24451,24141,48592,8990,No,15.61%,3451,6%,3416,5.93%
12133,Florida,Washington County,24892,13631,11261,10598,9401,10161,9155,19316,5576,No,22.40%,3896,16%,822,3.30%
13001,Georgia,Appling County,18368,9294,9074,7197,7139,6284,6520,12804,5564,No,30.29%,3607,20%,1728,9.41%
13003,Georgia,Atkinson County,8284,4203,4081,3291,3143,2317,2371,4688,3596,No,43.41%,1459,18%,2050,24.75%
13005,Georgia,Bacon County,11198,5562,5636,4558,4592,4094,4273,8367,2831,No,25.28%,1790,16%,890,7.95%
13007,Georgia,Baker County,3366,1606,1760,858,876,796,823,1619,1747,Yes,51.90%,1551,46%,152,4.52%
13009,Georgia,Baldwin County,46367,23365,23002,13011,12750,12638,12391,25029,21338,No,46.02%,19150,41%,977,2.11%
13011,Georgia,Banks County,18316,9314,9002,8766,8517,8204,8075,16279,2037,No,11.12%,518,3%,1107,6.04%
13013,Georgia,Barrow County,70169,34568,35601,28668,29163,25556,26441,51997,18172,No,25.90%,8041,11%,6629,9.45%
13015,Georgia,Bartow County,100661,49684,50977,42976,43750,39370,40569,79939,20722,No,20.59%,10604,11%,7858,7.81%
13017,Georgia,Ben Hill County,17538,8393,9145,5359,5539,4876,5128,10004,7534,No,42.96%,6169,35%,1054,6.01%
13019,Georgia,Berrien County,19041,9416,9625,8225,8268,7748,7908,15656,3385,No,17.78%,2132,11%,958,5.03%
13021,Georgia,Bibb County,156462,74007,82455,33271,34811,31313,33224,64537,91925,Yes,58.75%,82900,53%,4938,3.16%
13023,Georgia,Bleckley County,12913,6149,6764,4511,4722,4357,4615,8972,3941,No,30.52%,3421,26%,325,2.52%
13025,Georgia,Brantley County,18587,9212,9375,8744,8849,8560,8684,17244,1343,No,7.23%,619,3%,396,2.13%
13027,Georgia,Brooks County,15403,7488,7915,4894,4857,4481,4559,9040,6363,No,41.31%,5319,35%,835,5.42%
13029,Georgia,Bryan County,32214,15954,16260,12847,12966,12114,12180,24294,7920,No,24.59%,4823,15%,1856,5.76%
13031,Georgia,Bulloch County,72694,36158,36536,24633,24072,23462,23155,46617,26077,No,35.87%,21338,29%,2634,3.62%
13033,Georgia,Burke County,23125,11134,11991,5673,5627,5404,5421,10825,12300,Yes,53.19%,11323,49%,653,2.82%
13035,Georgia,Butts County,23524,12498,11026,8414,8026,8069,7797,15866,7658,No,32.55%,6589,28%,698,2.97%
13037,Georgia,Calhoun County,6504,3870,2634,1383,959,1242,911,2153,4351,Yes,66.90%,4035,62%,272,4.18%
13039,Georgia,Camden County,51402,26261,25141,20176,18617,18875,17562,36437,14965,No,29.11%,9927,19%,2917,5.67%
13043,Georgia,Candler County,11117,5503,5614,4083,3978,3404,3513,6917,4200,No,37.78%,2829,25%,1213,10.91%
13045,Georgia,Carroll County,111580,54402,57178,42878,44181,39521,41362,80883,30697,No,27.51%,20712,19%,7172,6.43%
13047,Georgia,Catoosa County,65046,31549,33497,29632,31577,28950,30931,59881,5165,No,7.94%,1649,3%,1589,2.44%
13049,Georgia,Charlton County,13295,8035,5260,4825,3850,4498,3770,8268,5027,No,37.81%,4260,32%,466,3.51%
13051,Georgia,Chatham County,276434,133656,142778,74737,76511,67786,70663,138449,137985,No,49.92%,111249,40%,16276,5.89%
13053,Georgia,Chattahoochee County,13037,8339,4698,6210,3218,5236,2733,7969,5068,No,38.87%,2561,20%,1833,14.06%
13055,Georgia,Chattooga County,25725,13346,12379,10984,11125,10415,10724,21139,4586,No,17.83%,2943,11%,1174,4.56%
13057,Georgia,Cherokee County,221315,109165,112150,98109,100149,87592,90895,178487,42828,No,19.35%,13624,6%,22205,10.03%
13059,Georgia,Clarke County,120266,57414,62852,38806,40932,32941,35534,68475,51791,No,43.06%,32412,27%,12834,10.67%
13061,Georgia,Clay County,3116,1416,1700,570,636,561,621,1182,1934,Yes,62.07%,1856,60%,26,0.83%
13063,Georgia,Clayton County,265888,126790,139098,34174,32560,19009,19978,38987,226901,Yes,85.34%,178098,67%,35545,13.37%
13065,Georgia,Clinch County,6718,3311,3407,2314,2367,2198,2298,4496,2222,No,33.08%,1873,28%,240,3.57%
13067,Georgia,Cobb County,707442,343797,363645,232413,235465,192159,199721,391880,315562,No,44.61%,185336,26%,89408,12.64%
13069,Georgia,Coffee County,43170,22113,21057,15216,14908,12846,13002,25848,17322,No,40.13%,12021,28%,4590,10.63%
13071,Georgia,Colquitt County,46137,22985,23152,16958,16896,12838,13798,26636,19501,No,42.27%,10730,23%,8195,17.76%
13073,Georgia,Columbia County,131627,64128,67499,49842,51099,46802,48262,95064,36563,No,27.78%,21049,16%,7383,5.61%
13075,Georgia,Cook County,16923,8256,8667,5893,5968,5362,5606,10968,5955,No,35.19%,4667,28%,998,5.90%
13077,Georgia,Coweta County,130929,63988,66941,50649,51596,46506,48084,94590,36339,No,27.75%,23389,18%,8953,6.84%
13079,Georgia,Crawford County,12600,6372,6228,4878,4633,4712,4528,9240,3360,No,26.67%,2787,22%,333,2.64%
13081,Georgia,Crisp County,23606,11310,12296,6183,6520,5803,6238,12041,11565,No,48.99%,10364,44%,808,3.42%
13083,Georgia,Dade County,16490,8126,8364,7826,8000,7670,7883,15553,937,No,5.68%,208,1%,321,1.95%
13085,Georgia,Dawson County,22422,11224,11198,10859,10821,10453,10471,20924,1498,No,6.68%,169,1%,867,3.87%
13087,Georgia,Decatur County,27509,13419,14090,7601,7785,7006,7271,14277,13232,No,48.10%,11422,42%,1517,5.51%
13089,Georgia,DeKalb County,707089,338498,368591,132429,131800,102703,108936,211639,495450,Yes,70.07%,385868,55%,67461,9.54%
13091,Georgia,Dodge County,21329,11145,10184,7470,7029,7103,6831,13934,7395,No,34.67%,6396,30%,770,3.61%
13093,Georgia,Dooly County,14318,7751,6567,3887,3160,3379,2844,6223,8095,Yes,56.54%,7020,49%,942,6.58%
13095,Georgia,Dougherty County,94501,44179,50322,13732,14574,12863,13839,26702,67799,Yes,71.74%,63756,67%,2478,2.62%
13097,Georgia,Douglas County,133971,64391,69580,36184,36776,31296,32462,63758,70213,Yes,52.41%,55194,41%,11724,8.75%
13099,Georgia,Early County,10594,4963,5631,2513,2716,2431,2631,5062,5532,Yes,52.22%,5189,49%,216,2.04%
13101,Georgia,Echols County,3988,1989,1999,1771,1785,1236,1312,2548,1440,No,36.11%,204,5%,1132,28.39%
13103,Georgia,Effingham County,53293,26570,26723,22184,22135,21390,21491,42881,10412,No,19.54%,7312,14%,1708,3.20%
13105,Georgia,Elbert County,19684,9426,10258,6544,6882,6065,6489,12554,7130,No,36.22%,5852,30%,1056,5.36%
13107,Georgia,Emanuel County,22898,11406,11492,7306,7312,6796,6983,13779,9119,No,39.82%,7819,34%,1016,4.44%
13109,Georgia,Evans County,10689,5206,5483,3481,3658,2924,3225,6149,4540,No,42.47%,3247,30%,1270,11.88%
13111,Georgia,Fannin County,23492,11509,11983,11212,11695,10998,11502,22500,992,No,4.22%,127,1%,451,1.92%
13113,Georgia,Fayette County,107524,51986,55538,38046,39879,34987,36817,71804,35720,No,33.22%,22438,21%,7189,6.69%
13115,Georgia,Floyd County,96177,46654,49523,37824,40156,33440,36543,69983,26194,No,27.24%,14224,15%,9513,9.89%
13117,Georgia,Forsyth County,187928,93301,94627,81835,82666,73105,74883,147988,39940,No,21.25%,5830,3%,18033,9.60%
13119,Georgia,Franklin County,21894,10735,11159,9496,9824,9067,9475,18542,3352,No,15.31%,1977,9%,927,4.23%
13121,Georgia,Fulton County,977773,477103,500670,233427,226411,199844,197651,397495,580278,Yes,59.35%,435883,45%,76997,7.87%
13123,Georgia,Gilmer County,28190,14082,14108,13599,13658,12180,12484,24664,3526,No,12.51%,197,1%,2943,10.44%
13125,Georgia,Glascock County,3142,1532,1610,1362,1450,1341,1436,2777,365,No,11.62%,280,9%,39,1.24%
13127,Georgia,Glynn County,81022,38419,42603,27077,29425,24706,27431,52137,28885,No,35.65%,21483,27%,5305,6.55%
13129,Georgia,Gordon County,55766,27774,27992,25603,25874,21537,22548,44085,11681,No,20.95%,2371,4%,8085,14.50%
13131,Georgia,Grady County,25440,12423,13017,8632,8650,7324,7680,15004,10436,No,41.02%,7327,29%,2791,10.97%
13133,Georgia,Greene County,16092,7849,8243,4900,4909,4441,4535,8976,7116,No,44.22%,5956,37%,992,6.16%
13135,Georgia,Gwinnett County,842046,413906,428140,254917,251440,175478,181336,356814,485232,Yes,57.63%,214601,25%,174315,20.70%
13137,Georgia,Habersham County,43520,20448,23072,18798,20708,16154,18275,34429,9091,No,20.89%,1775,4%,5706,13.11%
13139,Georgia,Hall County,185416,92783,92633,81139,81121,56741,59493,116234,69182,No,37.31%,14803,8%,49914,26.92%
13141,Georgia,Hancock County,8996,4935,4061,1313,933,1215,917,2132,6864,Yes,76.30%,6603,73%,159,1.77%
13143,Georgia,Haralson County,28400,13807,14593,12839,13555,12669,13401,26070,2330,No,8.20%,1361,5%,366,1.29%
13145,Georgia,Harris County,32550,16231,16319,12987,12974,12582,12594,25176,7374,No,22.65%,5642,17%,937,2.88%
13147,Georgia,Hart County,25518,12645,12873,9900,10168,9479,9835,19314,6204,No,24.31%,4806,19%,870,3.41%
13149,Georgia,Heard County,11633,5744,5889,5008,5069,4881,4985,9866,1767,No,15.19%,1234,11%,272,2.34%
13151,Georgia,Henry County,209053,100176,108877,57414,59031,52531,54301,106832,102221,No,48.90%,80617,39%,12760,6.10%
13153,Georgia,Houston County,146136,71433,74703,47265,47294,43298,43749,87047,59089,No,40.43%,43018,29%,9265,6.34%
13155,Georgia,Irwin County,9600,4912,4688,3396,3370,3262,3265,6527,3073,No,32.01%,2672,28%,288,3.00%
13157,Georgia,Jackson County,60571,30036,30535,26751,27316,24818,25537,50355,10216,No,16.87%,4278,7%,4023,6.64%
13159,Georgia,Jasper County,13630,6711,6919,5117,5129,4868,4919,9787,3843,No,28.20%,3064,22%,548,4.02%
13161,Georgia,Jeff Davis County,15156,7503,7653,6207,6310,5383,5620,11003,4153,No,27.40%,2306,15%,1662,10.97%
13163,Georgia,Jefferson County,16432,7932,8500,3698,3600,3390,3441,6831,9601,Yes,58.43%,8864,54%,563,3.43%
13165,Georgia,Jenkins County,9213,4889,4324,2658,2370,2423,2259,4682,4531,No,49.18%,3986,43%,494,5.36%
13167,Georgia,Johnson County,9897,5554,4343,3473,2837,3375,2772,6147,3750,No,37.89%,3443,35%,213,2.15%
13169,Georgia,Jones County,28577,13813,14764,10299,10711,10129,10578,20707,7870,No,27.54%,6994,24%,372,1.30%
13171,Georgia,Lamar County,18057,8647,9410,5909,6131,5757,5974,11731,6326,No,35.03%,5584,31%,408,2.26%
13173,Georgia,Lanier County,10400,5245,5155,3734,3679,3524,3490,7014,3386,No,32.56%,2514,24%,518,4.98%
13175,Georgia,Laurens County,48041,22871,25170,14435,15144,13914,14735,28649,19392,No,40.37%,17279,36%,1144,2.38%
13177,Georgia,Lee County,28746,14402,14344,10861,11045,10554,10798,21352,7394,No,25.72%,5714,20%,690,2.40%
13179,Georgia,Liberty County,65471,33085,32386,17558,15887,14712,13410,28122,37349,Yes,57.05%,26872,41%,7512,11.47%
13181,Georgia,Lincoln County,7737,3779,3958,2556,2558,2523,2505,5028,2709,No,35.01%,2481,32%,109,1.41%
13183,Georgia,Long County,16048,8011,8037,5578,5405,4750,4731,9481,6567,No,40.92%,4150,26%,1937,12.07%
13185,Georgia,Lowndes County,114552,56133,58419,33536,33951,31133,31836,62969,51583,No,45.03%,42417,37%,5950,5.19%
13187,Georgia,Lumpkin County,30611,15302,15309,14513,14669,13895,14087,27982,2629,No,8.59%,476,2%,1353,4.42%
13189,Georgia,McDuffie County,21663,10133,11530,5883,6497,5672,6297,11969,9694,No,44.75%,8804,41%,534,2.47%
13191,Georgia,McIntosh County,13839,6757,7082,4327,4315,4243,4237,8480,5359,No,38.72%,4894,35%,228,1.65%
13193,Georgia,Macon County,14263,7784,6479,2911,2375,2612,2223,4835,9428,Yes,66.10%,8553,60%,577,4.05%
13195,Georgia,Madison County,27922,13784,14138,12270,12532,11735,12030,23765,4157,No,14.89%,2464,9%,1182,4.23%
13197,Georgia,Marion County,8711,4283,4428,2768,2760,2486,2578,5064,3647,No,41.87%,2858,33%,592,6.80%
13199,Georgia,Meriwether County,21273,10157,11116,6136,6412,5967,6282,12249,9024,No,42.42%,8266,39%,389,1.83%
13201,Georgia,Miller County,5969,2904,3065,2066,2081,2032,2045,4077,1892,No,31.70%,1690,28%,115,1.93%
13205,Georgia,Mitchell County,23144,12053,11091,6009,5528,5473,5224,10697,12447,Yes,53.78%,11110,48%,1025,4.43%
13207,Georgia,Monroe County,26637,13343,13294,9933,9890,9634,9663,19297,7340,No,27.56%,6175,23%,628,2.36%
13209,Georgia,Montgomery County,8913,4546,4367,3253,3144,2995,2947,5942,2971,No,33.33%,2385,27%,559,6.27%
13211,Georgia,Morgan County,17881,8677,9204,6530,6680,6335,6500,12835,5046,No,28.22%,4215,24%,495,2.77%
13213,Georgia,Murray County,39392,19570,19822,18755,19069,16276,16798,33074,6318,No,16.04%,441,1%,5376,13.65%
13215,Georgia,Muscogee County,198413,96692,101721,48030,47754,42285,43076,85361,113052,Yes,56.98%,91417,46%,14262,7.19%
13217,Georgia,Newton County,101505,48245,53260,27257,28426,25444,26702,52146,49359,No,48.63%,42467,42%,4825,4.75%
13219,Georgia,Oconee County,33619,16383,17236,14735,15459,14043,14787,28830,4789,No,14.24%,1770,5%,1535,4.57%
13221,Georgia,Oglethorpe County,14618,7268,7350,5834,5854,5562,5631,11193,3425,No,23.43%,2535,17%,558,3.82%
13223,Georgia,Paulding County,144800,70677,74123,56506,57975,53429,54887,108316,36484,No,25.20%,25362,18%,7572,5.23%
13225,Georgia,Peach County,27622,13493,14129,7216,6988,6195,6233,12428,15194,Yes,55.01%,12627,46%,2024,7.33%
13227,Georgia,Pickens County,29268,14373,14895,13873,14411,13471,14057,27528,1740,No,5.95%,409,1%,865,2.96%
13229,Georgia,Pierce County,18844,9345,9499,8281,8396,7818,8027,15845,2999,No,15.91%,1696,9%,956,5.07%
13231,Georgia,Pike County,17810,8754,9056,7689,7852,7584,7773,15357,2453,No,13.77%,1888,11%,225,1.26%
13233,Georgia,Polk County,41188,20362,20826,17156,17387,14550,15337,29887,11301,No,27.44%,5296,13%,5254,12.76%
13235,Georgia,Pulaski County,11720,5042,6678,3518,4246,3309,4070,7379,4341,No,37.04%,3663,31%,456,3.89%
13237,Georgia,Putnam County,21198,10231,10967,7382,7622,6751,7097,13848,7350,No,34.67%,5728,27%,1413,6.67%
13239,Georgia,Quitman County,2404,1161,1243,580,607,571,598,1169,1235,Yes,51.37%,1190,50%,28,1.16%
13241,Georgia,Rabun County,16297,8026,8271,7658,7895,7006,7392,14398,1899,No,11.65%,243,1%,1308,8.03%
13243,Georgia,Randolph County,7327,3409,3918,1400,1414,1352,1380,2732,4595,Yes,62.71%,4415,60%,122,1.67%
13245,Georgia,Richmond County,202587,98591,103996,41569,40055,38199,37403,75602,126985,Yes,62.68%,111273,55%,9126,4.50%
13247,Georgia,Rockdale County,85820,40757,45063,20047,20657,16214,17503,33717,52103,Yes,60.71%,41221,48%,8601,10.02%
13249,Georgia,Schley County,4990,2407,2583,1895,1914,1799,1822,3621,1369,No,27.43%,1086,22%,214,4.29%
13251,Georgia,Screven County,14202,6937,7265,3878,3990,3814,3932,7746,6456,No,45.46%,6037,43%,207,1.46%
13253,Georgia,Seminole County,8947,4314,4633,2864,2933,2751,2841,5592,3355,No,37.50%,2974,33%,253,2.83%
13255,Georgia,Spalding County,63865,31016,32849,20130,20581,18841,19703,38544,25321,No,39.65%,21191,33%,2653,4.15%
13257,Georgia,Stephens County,25891,12420,13471,10685,11471,10359,11209,21568,4323,No,16.70%,2923,11%,705,2.72%
13259,Georgia,Stewart County,6042,3729,2313,1955,869,807,835,1642,4400,Yes,72.82%,3024,50%,1630,26.98%
13261,Georgia,Sumter County,31554,14949,16605,6918,7136,6145,6535,12680,18874,Yes,59.81%,16505,52%,1790,5.67%
13263,Georgia,Talbot County,6517,3083,3434,1306,1305,1280,1276,2556,3961,Yes,60.78%,3778,58%,115,1.76%
13265,Georgia,Taliaferro County,1680,814,866,293,348,272,332,604,1076,Yes,64.05%,997,59%,44,2.62%
13267,Georgia,Tattnall County,25384,14815,10569,9333,7973,7867,7052,14919,10465,No,41.23%,7530,30%,2735,10.77%
13269,Georgia,Taylor County,8420,3999,4421,2485,2542,2399,2494,4893,3527,No,41.89%,3255,39%,175,2.08%
13271,Georgia,Telfair County,16349,9474,6875,5740,4348,4157,4139,8296,8053,No,49.26%,5920,36%,2194,13.42%
13273,Georgia,Terrell County,9045,4343,4702,1662,1699,1603,1657,3260,5785,Yes,63.96%,5499,61%,184,2.03%
13275,Georgia,Thomas County,44724,21252,23472,13066,13828,12484,13306,25790,18934,No,42.34%,16662,37%,1467,3.28%
13277,Georgia,Tift County,41064,19886,21178,13273,13731,11167,12005,23172,17892,No,43.57%,12793,31%,4285,10.43%
13279,Georgia,Toombs County,27315,12946,14369,9456,10138,7895,8952,16847,10468,No,38.32%,6928,25%,3117,11.41%
13281,Georgia,Towns County,10495,5048,5447,4930,5311,4828,5211,10039,456,No,4.34%,83,1%,225,2.14%
13283,Georgia,Treutlen County,6769,3409,3360,2231,2218,2166,2172,4338,2431,No,35.91%,2229,33%,134,1.98%
13285,Georgia,Troup County,68468,32931,35537,20760,21720,19658,20868,40526,27942,No,40.81%,23529,34%,2401,3.51%
13287,Georgia,Turner County,8410,4194,4216,2383,2479,2249,2372,4621,3789,No,45.05%,3377,40%,337,4.01%
13289,Georgia,Twiggs County,8447,4142,4305,2374,2413,2339,2364,4703,3744,No,44.32%,3502,41%,139,1.65%
13291,Georgia,Union County,21451,10412,11039,10126,10741,9858,10481,20339,1112,No,5.18%,148,1%,593,2.76%
13293,Georgia,Upson County,26630,12705,13925,8950,9588,8693,9396,18089,8541,No,32.07%,7478,28%,634,2.38%
13295,Georgia,Walker County,68094,33485,34609,31165,32434,30581,31969,62550,5544,No,8.14%,2966,4%,1198,1.76%
13297,Georgia,Walton County,84575,41286,43289,33635,34638,32159,33393,65552,19023,No,22.49%,13622,16%,3285,3.88%
13299,Georgia,Ware County,35821,17814,18007,11834,12331,11261,11898,23159,12662,No,35.35%,10618,30%,1253,3.50%
13301,Georgia,Warren County,5578,2604,2974,1041,1081,1032,1063,2095,3483,Yes,62.44%,3374,60%,53,0.95%
13303,Georgia,Washington County,20879,10622,10257,4959,4571,4722,4499,9221,11658,Yes,55.84%,11018,53%,431,2.06%
13305,Georgia,Wayne County,30305,15736,14569,11860,11261,10840,10730,21570,8735,No,28.82%,6247,21%,1882,6.21%
13307,Georgia,Webster County,2793,1398,1395,793,766,750,727,1477,1316,No,47.12%,1184,42%,112,4.01%
13309,Georgia,Wheeler County,7888,5127,2761,2830,1991,2601,1882,4483,3405,No,43.17%,2972,38%,400,5.07%
13311,Georgia,White County,27556,13391,14165,12800,13507,12442,13190,25632,1924,No,6.98%,560,2%,732,2.66%
13313,Georgia,Whitfield County,103359,51657,51702,47124,47333,30595,32434,63029,40330,No,39.02%,4229,4%,33856,32.76%
13315,Georgia,Wilcox County,9068,5360,3708,3125,2557,2919,2484,5403,3665,No,40.42%,3217,35%,338,3.73%
13317,Georgia,Wilkes County,10076,4816,5260,2790,2790,2606,2673,5279,4797,No,47.61%,4254,42%,373,3.70%
13319,Georgia,Wilkinson County,9577,4615,4962,2761,2926,2661,2846,5507,4070,No,42.50%,3683,38%,231,2.41%
13321,Georgia,Worth County,21741,10484,11257,7314,7624,7139,7455,14594,7147,No,32.87%,6430,30%,438,2.01%
15001,Hawaii,Hawaii County,189191,94973,94218,33515,31182,30132,27925,58057,131134,Yes,69.31%,1465,1%,22614,11.95%
15003,Hawaii,Honolulu County,976372,493023,483349,124120,95067,107577,81792,189369,787003,Yes,80.60%,26894,3%,85789,8.79%
15005,Hawaii,Kalawao County,90,42,48,14,11,13,11,24,66,Yes,73.33%,0,0%,1,1.11%
15007,Hawaii,Kauai County,68434,34397,34037,11676,11142,10564,10048,20612,47822,Yes,69.88%,364,1%,6806,9.95%
15009,Hawaii,Maui County,158226,79530,78696,29572,27245,25992,24064,50056,108170,Yes,68.36%,1182,1%,16534,10.45%
16001,Idaho,Ada County,409061,204555,204506,189070,189350,175352,176416,351768,57293,No,14.01%,4955,1%,30396,7.43%
16003,Idaho,Adams County,3915,2005,1910,1948,1838,1904,1777,3681,234,No,5.98%,6,0%,119,3.04%
16005,Idaho,Bannock County,83800,41699,42101,38315,38764,35698,36300,71998,11802,No,14.08%,682,1%,6110,7.29%
16007,Idaho,Bear Lake County,5907,2930,2977,2874,2899,2755,2804,5559,348,No,5.89%,15,0%,234,3.96%
16009,Idaho,Benewah County,9117,4651,4466,4027,3872,3930,3782,7712,1405,No,15.41%,32,0%,275,3.02%
16011,Idaho,Bingham County,45474,22864,22610,20574,20250,16997,17063,34060,11414,No,25.10%,220,0%,7939,17.46%
16013,Idaho,Blaine County,21146,10782,10364,10336,9937,8321,8088,16409,4737,No,22.40%,71,0%,4288,20.28%
16015,Idaho,Boise County,6835,3519,3316,3388,3165,3299,3049,6348,487,No,7.13%,21,0%,249,3.64%
16017,Idaho,Bonner County,40476,20284,20192,19548,19386,19169,18953,38122,2354,No,5.82%,81,0%,957,2.36%
16019,Idaho,Bonneville County,106684,53018,53666,50492,51140,44501,45554,90055,16629,No,15.59%,729,1%,12951,12.14%
16021,Idaho,Boundary County,10808,5475,5333,5214,5029,5017,4846,9863,945,No,8.74%,39,0%,454,4.20%
16023,Idaho,Butte County,2740,1405,1335,1369,1278,1307,1226,2533,207,No,7.55%,11,0%,124,4.53%
16025,Idaho,Camas County,1077,564,513,535,489,497,461,958,119,No,11.05%,5,0%,72,6.69%
16027,Idaho,Canyon County,193888,95807,98081,90036,92195,68112,71056,139168,54720,No,28.22%,1454,1%,47024,24.25%
16029,Idaho,Caribou County,6787,3395,3392,3304,3294,3126,3138,6264,523,No,7.71%,6,0%,367,5.41%
16031,Idaho,Cassia County,23249,11828,11421,11330,10920,8361,8355,16716,6533,No,28.10%,129,1%,6018,25.88%
16033,Idaho,Clark County,869,473,396,446,369,259,228,487,382,No,43.96%,8,1%,354,40.74%
16035,Idaho,Clearwater County,8590,4664,3926,4428,3711,4255,3630,7885,705,No,8.21%,25,0%,289,3.36%
16037,Idaho,Custer County,4331,2266,2065,2216,2004,2105,1935,4040,291,No,6.72%,9,0%,191,4.41%
16039,Idaho,Elmore County,26223,13604,12619,12155,11190,10179,9466,19645,6578,No,25.08%,743,3%,4154,15.84%
16041,Idaho,Franklin County,12786,6469,6317,6322,6138,5908,5787,11695,1091,No,8.53%,34,0%,858,6.71%
16043,Idaho,Fremont County,12957,6798,6159,6553,5962,5753,5309,11062,1895,No,14.63%,86,1%,1609,12.42%
16045,Idaho,Gem County,16673,8255,8418,7920,8059,7283,7508,14791,1882,No,11.29%,27,0%,1294,7.76%
16047,Idaho,Gooding County,15291,7903,7388,7508,7049,5266,5263,10529,4762,No,31.14%,67,0%,4383,28.66%
16049,Idaho,Idaho County,16308,8493,7815,8016,7391,7788,7229,15017,1291,No,7.92%,48,0%,486,2.98%
16051,Idaho,Jefferson County,26684,13436,13248,12916,12781,11629,11681,23310,3374,No,12.64%,88,0%,2761,10.35%
16053,Idaho,Jerome County,22499,11535,10964,10981,10430,7260,7321,14581,7918,No,35.19%,120,1%,7374,32.77%
16055,Idaho,Kootenai County,142357,70120,72237,66783,68511,64437,65955,130392,11965,No,8.40%,516,0%,5820,4.09%
16057,Idaho,Latah County,38184,19603,18581,18323,17471,17718,16845,34563,3621,No,9.48%,329,1%,1447,3.79%
16059,Idaho,Lemhi County,7758,3959,3799,3820,3645,3745,3549,7294,464,No,5.98%,40,1%,210,2.71%
16061,Idaho,Lewis County,3889,1959,1930,1784,1759,1727,1698,3425,464,No,11.93%,14,0%,149,3.83%
16063,Idaho,Lincoln County,5277,2709,2568,2591,2477,1804,1810,3614,1663,No,31.51%,25,0%,1518,28.77%
16065,Idaho,Madison County,37456,18520,18936,17797,18119,16749,17032,33781,3675,No,9.81%,230,1%,2361,6.30%
16067,Idaho,Minidoka County,20037,10053,9984,9510,9499,6416,6577,12993,7044,No,35.15%,124,1%,6528,32.58%
16069,Idaho,Nez Perce County,39531,19573,19958,17691,18099,17203,17675,34878,4653,No,11.77%,182,0%,1212,3.07%
16071,Idaho,Oneida County,4215,2143,2072,2098,2025,2046,1954,4000,215,No,5.10%,10,0%,133,3.16%
16073,Idaho,Owyhee County,11439,5871,5568,5410,5096,3963,3899,7862,3577,No,31.27%,87,1%,2957,25.85%
16075,Idaho,Payette County,22639,11197,11442,10613,10814,8939,9282,18221,4418,No,19.51%,80,0%,3513,15.52%
16077,Idaho,Power County,7778,3955,3823,3741,3540,2543,2517,5060,2718,No,34.94%,70,1%,2389,30.71%
16079,Idaho,Shoshone County,12702,6374,6328,6101,6032,5901,5881,11782,920,No,7.24%,38,0%,414,3.26%
16081,Idaho,Teton County,10052,5263,4789,5135,4658,4229,3955,8184,1868,No,18.58%,33,0%,1702,16.93%
16083,Idaho,Twin Falls County,78595,38728,39867,36820,37874,31325,33117,64442,14153,No,18.01%,494,1%,11322,14.41%
16085,Idaho,Valley County,9545,4901,4644,4746,4498,4571,4344,8915,630,No,6.60%,18,0%,403,4.22%
16087,Idaho,Washington County,10099,5007,5092,4774,4839,3901,4087,7988,2111,No,20.90%,36,0%,1752,17.35%
17001,Illinois,Adams County,67197,32719,34478,30581,32458,30220,32076,62296,4901,No,7.29%,2406,4%,903,1.34%
17003,Illinois,Alexander County,7748,3935,3813,2385,2344,2305,2309,4614,3134,No,40.45%,2791,36%,167,2.16%
17005,Illinois,Bond County,17644,9254,8390,8176,7916,7810,7795,15605,2039,No,11.56%,1141,6%,572,3.24%
17007,Illinois,Boone County,53940,26919,27021,25055,25236,19968,20550,40518,13422,No,24.88%,1332,2%,10835,20.09%
17009,Illinois,Brown County,6914,4438,2476,3015,2437,2738,2415,5153,1761,No,25.47%,1306,19%,413,5.97%
17011,Illinois,Bureau County,34323,16799,17524,16293,16978,14920,15736,30656,3667,No,10.68%,261,1%,2825,8.23%
17013,Illinois,Calhoun County,5014,2517,2497,2493,2468,2472,2449,4921,93,No,1.85%,9,0%,41,0.82%
17015,Illinois,Carroll County,15011,7501,7510,7264,7310,7049,7102,14151,860,No,5.73%,142,1%,478,3.18%
17017,Illinois,Cass County,13338,6770,6568,6345,6224,5123,5283,10406,2932,No,21.98%,488,4%,2381,17.85%
17019,Illinois,Champaign County,203276,101581,101695,75983,76052,71041,71657,142698,60578,No,29.80%,25898,13%,11205,5.51%
17021,Illinois,Christian County,34638,17558,17080,16817,16686,16537,16498,33035,1603,No,4.63%,535,2%,519,1.50%
17023,Illinois,Clark County,16209,7922,8287,7786,8130,7686,8051,15737,472,No,2.91%,86,1%,187,1.15%
17025,Illinois,Clay County,13766,6785,6981,6650,6820,6561,6748,13309,457,No,3.32%,66,0%,175,1.27%
17027,Illinois,Clinton County,38061,19623,18438,18070,17828,17477,17493,34970,3091,No,8.12%,1439,4%,1088,2.86%
17029,Illinois,Coles County,53655,25860,27795,24151,25915,23638,25442,49080,4575,No,8.53%,2120,4%,1211,2.26%
17031,Illinois,Cook County,5231351,2535560,2695791,1708935,1736690,1105834,1167078,2272912,2958439,Yes,56.55%,1299143,25%,1285944,24.58%
17033,Illinois,Crawford County,19600,10144,9456,9079,9226,8867,9099,17966,1634,No,8.34%,945,5%,396,2.02%
17035,Illinois,Cumberland County,10968,5491,5477,5398,5386,5367,5348,10715,253,No,2.31%,45,0%,85,0.77%
17037,Illinois,DeKalb County,104704,52095,52609,46411,46078,41267,41303,82570,22134,No,21.14%,7212,7%,11033,10.54%
17039,Illinois,De Witt County,16434,8178,8256,7945,8079,7776,7924,15700,734,No,4.47%,121,1%,354,2.15%
17041,Illinois,Douglas County,19853,9836,10017,9609,9805,8940,9234,18174,1679,No,8.46%,94,0%,1319,6.64%
17043,Illinois,DuPage County,927987,455137,472850,374636,386477,313643,329501,643144,284843,No,30.69%,46812,5%,127947,13.79%
17045,Illinois,Edgar County,18191,8820,9371,8678,9212,8593,9111,17704,487,No,2.68%,87,0%,205,1.13%
17047,Illinois,Edwards County,6684,3292,3392,3231,3332,3196,3306,6502,182,No,2.72%,31,0%,71,1.06%
17049,Illinois,Effingham County,34353,17145,17208,16825,16924,16531,16682,33213,1140,No,3.32%,118,0%,626,1.82%
17051,Illinois,Fayette County,22014,11590,10424,10439,10249,10245,10139,20384,1630,No,7.40%,1004,5%,360,1.64%
17053,Illinois,Ford County,14008,6898,7110,6695,6972,6521,6834,13355,653,No,4.66%,110,1%,354,2.53%
17055,Illinois,Franklin County,39407,19305,20102,18850,19636,18612,19430,38042,1365,No,3.46%,195,0%,529,1.34%
17057,Illinois,Fulton County,36651,19019,17632,17349,17253,16821,17088,33909,2742,No,7.48%,1368,4%,945,2.58%
17059,Illinois,Gallatin County,5430,2646,2784,2585,2724,2545,2689,5234,196,No,3.61%,24,0%,77,1.42%
17061,Illinois,Greene County,13576,6850,6726,6657,6651,6590,6599,13189,387,No,2.85%,130,1%,128,0.94%
17063,Illinois,Grundy County,50281,25036,25245,24102,24323,21964,22415,44379,5902,No,11.74%,728,1%,4339,8.63%
17065,Illinois,Hamilton County,8370,4116,4254,4042,4165,3994,4120,8114,256,No,3.06%,43,1%,112,1.34%
17067,Illinois,Hancock County,18891,9296,9595,9138,9417,9029,9307,18336,555,No,2.94%,63,0%,248,1.31%
17069,Illinois,Hardin County,4258,2146,2112,2083,2059,2058,2019,4077,181,No,4.25%,21,0%,69,1.62%
17071,Illinois,Henderson County,7043,3458,3585,3392,3521,3363,3467,6830,213,No,3.02%,18,0%,87,1.24%
17073,Illinois,Henry County,50155,24968,25187,24000,24234,22725,23091,45816,4339,No,8.65%,891,2%,2627,5.24%
17075,Illinois,Iroquois County,29240,14255,14985,13822,14554,12940,13752,26692,2548,No,8.71%,294,1%,1786,6.11%
17077,Illinois,Jackson County,60071,30383,29688,24222,23011,23225,22084,45309,14762,No,24.57%,8764,15%,2500,4.16%
17079,Illinois,Jasper County,9614,4804,4810,4737,4731,4684,4696,9380,234,No,2.43%,17,0%,97,1.01%
17081,Illinois,Jefferson County,38720,19880,18840,17259,17021,16825,16778,33603,5117,No,13.22%,3397,9%,874,2.26%
17083,Illinois,Jersey County,22742,11131,11611,10844,11338,10743,11227,21970,772,No,3.39%,128,1%,254,1.12%
17085,Illinois,Jo Daviess County,22549,11351,11198,11079,10989,10714,10709,21423,1126,No,4.99%,137,1%,691,3.06%
17087,Illinois,Johnson County,12760,7117,5643,5975,5533,5740,5440,11180,1580,No,12.38%,1051,8%,397,3.11%
17089,Illinois,Kane County,522487,260488,261999,228172,228305,150217,155754,305971,216516,No,41.44%,31384,6%,162843,31.17%
17091,Illinois,Kankakee County,113040,55477,57563,45217,46668,40175,42275,82450,30590,No,27.06%,17504,15%,10525,9.31%
17093,Illinois,Kendall County,118105,58329,59776,51625,52620,42701,43998,86699,31406,No,26.59%,7214,6%,18952,16.05%
17095,Illinois,Knox County,52247,26226,26021,22710,23750,21441,22779,44220,8027,No,15.36%,4006,8%,2675,5.12%
17097,Illinois,Lake County,702120,350430,351690,292118,290679,224270,227993,452263,249857,No,35.59%,51414,7%,143779,20.48%
17099,Illinois,LaSalle County,112973,56623,56350,53618,54275,48845,50062,98907,14066,No,12.45%,2429,2%,9579,8.48%
17101,Illinois,Lawrence County,16604,9327,7277,7574,7089,7188,7003,14191,2413,No,14.53%,1656,10%,583,3.51%
17103,Illinois,Lee County,35037,18424,16613,16470,15906,15471,15237,30708,4329,No,12.36%,1813,5%,1876,5.35%
17105,Illinois,Livingston County,38647,19377,19270,17763,18100,16898,17447,34345,4302,No,11.13%,2027,5%,1675,4.33%
17107,Illinois,Logan County,30013,15201,14812,13318,13613,12818,13350,26168,3845,No,12.81%,2359,8%,946,3.15%
17109,Illinois,McDonough County,32537,16187,16350,14684,14788,14314,14468,28782,3755,No,11.54%,1758,5%,852,2.62%
17111,Illinois,McHenry County,308145,153638,154507,144745,145472,126791,129137,255928,52217,No,16.95%,4023,1%,36676,11.90%
17113,Illinois,McLean County,172281,83808,88473,70988,75718,67440,72368,139808,32473,No,18.85%,13106,8%,7946,4.61%
17115,Illinois,Macon County,110122,52771,57351,42047,45455,41166,44587,85753,24369,No,22.13%,18396,17%,2204,2.00%
17117,Illinois,Macoupin County,47231,23288,23943,22701,23315,22521,23107,45628,1603,No,3.39%,462,1%,453,0.96%
17119,Illinois,Madison County,267883,130893,136990,116972,121412,113364,118109,231473,36410,No,13.59%,21468,8%,7806,2.91%
17121,Illinois,Marion County,38894,19046,19848,17766,18589,17483,18361,35844,3050,No,7.84%,1583,4%,615,1.58%
17123,Illinois,Marshall County,12327,6106,6221,5976,6095,5832,5931,11763,564,No,4.58%,46,0%,340,2.76%
17125,Illinois,Mason County,14327,7053,7274,6891,7135,6817,7084,13901,426,No,2.97%,67,0%,137,0.96%
17127,Illinois,Massac County,15234,7255,7979,6652,7302,6478,7157,13635,1599,No,10.50%,878,6%,360,2.36%
17129,Illinois,Menard County,12722,6185,6537,6020,6356,5956,6285,12241,481,No,3.78%,130,1%,158,1.24%
17131,Illinois,Mercer County,16219,8016,8203,7873,8085,7722,7916,15638,581,No,3.58%,70,0%,336,2.07%
17133,Illinois,Monroe County,33357,16548,16809,16269,16498,16078,16255,32333,1024,No,3.07%,91,0%,479,1.44%
17135,Illinois,Montgomery County,29620,15502,14118,14417,13826,14138,13656,27794,1826,No,6.16%,980,3%,477,1.61%
17137,Illinois,Morgan County,35272,17751,17521,15825,16425,15446,16159,31605,3667,No,10.40%,2187,6%,780,2.21%
17139,Illinois,Moultrie County,14933,7260,7673,7138,7561,7074,7469,14543,390,No,2.61%,53,0%,167,1.12%
17141,Illinois,Ogle County,52848,26233,26615,25397,25854,23040,23648,46688,6160,No,11.66%,520,1%,4839,9.16%
17143,Illinois,Peoria County,187254,90832,96422,68766,72595,65504,69526,135030,52224,No,27.89%,33525,18%,7804,4.17%
17145,Illinois,Perry County,22058,12010,10048,9984,9619,9565,9511,19076,2982,No,13.52%,1921,9%,653,2.96%
17147,Illinois,Piatt County,16504,8202,8302,8025,8138,7936,8061,15997,507,No,3.07%,76,0%,189,1.15%
17149,Illinois,Pike County,16308,8156,8152,7775,8030,7670,7969,15639,669,No,4.10%,294,2%,183,1.12%
17151,Illinois,Pope County,4272,2244,2028,1994,1908,1959,1879,3838,434,No,10.16%,290,7%,74,1.73%
17153,Illinois,Pulaski County,5998,2869,3129,1851,1982,1818,1954,3772,2226,No,37.11%,1982,33%,103,1.72%
17155,Illinois,Putnam County,5886,2974,2912,2909,2856,2782,2724,5506,380,No,6.46%,36,1%,269,4.57%
17157,Illinois,Randolph County,32956,18112,14844,14993,14127,14439,13945,28384,4572,No,13.87%,3300,10%,887,2.69%
17159,Illinois,Richland County,16176,7912,8264,7703,8042,7606,7939,15545,631,No,3.90%,92,1%,231,1.43%
17161,Illinois,Rock Island County,147457,72486,74971,61415,64643,53428,56964,110392,37065,No,25.14%,13684,9%,17719,12.02%
17163,Illinois,St. Clair County,268858,129737,139121,87074,89281,82943,85460,168403,100455,No,37.36%,82213,31%,9483,3.53%
17165,Illinois,Saline County,24946,12252,12694,11303,11945,11174,11790,22964,1982,No,7.95%,1019,4%,364,1.46%
17167,Illinois,Sangamon County,199271,95557,103714,80080,86675,78503,85042,163545,35726,No,17.93%,24012,12%,3933,1.97%
17169,Illinois,Schuyler County,7457,3930,3527,3690,3447,3622,3401,7023,434,No,5.82%,245,3%,131,1.76%
17171,Illinois,Scott County,5290,2573,2717,2530,2676,2510,2654,5164,126,No,2.38%,20,0%,47,0.89%
17173,Illinois,Shelby County,22196,11018,11178,10849,11043,10760,10945,21705,491,No,2.21%,67,0%,211,0.95%
17175,Illinois,Stark County,5946,2939,3007,2877,2940,2848,2911,5759,187,No,3.14%,31,1%,65,1.09%
17177,Illinois,Stephenson County,46959,22718,24241,19869,21129,19256,20514,39770,7189,No,15.31%,4413,9%,1443,3.07%
17179,Illinois,Tazewell County,135949,67016,68933,64395,66713,63064,65530,128594,7355,No,5.41%,1612,1%,2849,2.10%
17181,Illinois,Union County,17647,8818,8829,8458,8543,8016,8193,16209,1438,No,8.15%,186,1%,891,5.05%
17183,Illinois,Vermilion County,80727,40046,40681,33268,34233,31589,32881,64470,16257,No,20.14%,10723,13%,3654,4.53%
17185,Illinois,Wabash County,11727,5760,5967,5573,5809,5508,5751,11259,468,No,3.99%,90,1%,152,1.30%
17187,Illinois,Warren County,17731,8679,9052,8181,8631,7400,7967,15367,2364,No,13.33%,380,2%,1586,8.94%
17189,Illinois,Washington County,14598,7357,7241,7173,7100,7061,7007,14068,530,No,3.63%,120,1%,226,1.55%
17191,Illinois,Wayne County,16574,8155,8419,7992,8270,7903,8178,16081,493,No,2.97%,72,0%,208,1.25%
17193,Illinois,White County,14568,7069,7499,6909,7374,6839,7328,14167,401,No,2.75%,79,1%,160,1.10%
17195,Illinois,Whiteside County,57846,28546,29300,27327,28136,24190,25216,49406,8440,No,14.59%,930,2%,6645,11.49%
17197,Illinois,Will County,682518,339023,343495,276863,278370,224164,228972,453136,229382,No,33.61%,78854,12%,109956,16.11%
17199,Illinois,Williamson County,66674,32991,33683,30415,31604,29710,31059,60769,5905,No,8.86%,2720,4%,1423,2.13%
17201,Illinois,Winnebago County,292069,142609,149460,117264,122133,101990,107818,209808,82261,No,28.16%,36723,13%,33540,11.48%
17203,Illinois,Woodford County,38971,19295,19676,18831,19194,18542,18921,37463,1508,No,3.87%,234,1%,617,1.58%
18001,Indiana,Adams County,34365,16987,17378,16683,17112,15986,16439,32425,1940,No,5.65%,133,0%,1462,4.25%
18003,Indiana,Allen County,360412,175824,184588,144052,150445,133341,140292,273633,86779,No,24.08%,43869,12%,24577,6.82%
18005,Indiana,Bartholomew County,79129,39259,39870,35553,36672,33073,34646,67719,11410,No,14.42%,1695,2%,5132,6.49%
18007,Indiana,Benton County,8804,4357,4447,4269,4360,4037,4180,8217,587,No,6.67%,66,1%,443,5.03%
18009,Indiana,Blackford County,12502,6186,6316,6041,6167,5966,6091,12057,445,No,3.56%,72,1%,165,1.32%
18011,Indiana,Boone County,58944,29064,29880,27705,28447,27013,27810,54823,4121,No,6.99%,677,1%,1459,2.48%
18013,Indiana,Brown County,15083,7484,7599,7313,7376,7240,7292,14532,551,No,3.65%,82,1%,194,1.29%
18015,Indiana,Carroll County,20095,10037,10058,9849,9853,9455,9554,19009,1086,No,5.40%,86,0%,795,3.96%
18017,Indiana,Cass County,38581,19285,19296,18042,18289,15660,16269,31929,6652,No,17.24%,754,2%,5123,13.28%
18019,Indiana,Clark County,111951,54875,57076,48927,50968,46238,48841,95079,16872,No,15.07%,8164,7%,5456,4.87%
18021,Indiana,Clay County,26837,13200,13637,12916,13380,12778,13235,26013,824,No,3.07%,127,0%,312,1.16%
18023,Indiana,Clinton County,33022,16289,16733,15939,16420,13529,14327,27856,5166,No,15.64%,184,1%,4672,14.15%
18025,Indiana,Crawford County,10665,5425,5240,5302,5131,5241,5072,10313,352,No,3.30%,46,0%,142,1.33%
18027,Indiana,Daviess County,32064,15957,16107,15536,15710,14853,15131,29984,2080,No,6.49%,214,1%,1370,4.27%
18029,Indiana,Dearborn County,49831,24770,25061,24198,24463,23952,24229,48181,1650,No,3.31%,355,1%,543,1.09%
18031,Indiana,Decatur County,26042,12840,13202,12489,12874,12268,12711,24979,1063,No,4.08%,120,0%,449,1.72%
18033,Indiana,DeKalb County,42321,20990,21331,20536,20836,20052,20403,40455,1866,No,4.41%,183,0%,1047,2.47%
18035,Indiana,Delaware County,117364,56407,60957,50497,54549,49541,53662,103203,14161,No,12.07%,8288,7%,2254,1.92%
18037,Indiana,Dubois County,42071,20771,21300,20365,20874,19043,19722,38765,3306,No,7.86%,190,0%,2686,6.38%
18039,Indiana,Elkhart County,199619,98669,100950,88874,91018,74736,78325,153061,46558,No,23.32%,11916,6%,29253,14.65%
18041,Indiana,Fayette County,24029,11816,12213,11453,11858,11342,11738,23080,949,No,3.95%,355,1%,247,1.03%
18043,Indiana,Floyd County,75283,36510,38773,33379,35523,32342,34694,67036,8247,No,10.95%,3892,5%,2162,2.87%
18045,Indiana,Fountain County,17119,8520,8599,8364,8421,8180,8251,16431,688,No,4.02%,66,0%,392,2.29%
18047,Indiana,Franklin County,22969,11475,11494,11311,11318,11210,11221,22431,538,No,2.34%,64,0%,225,0.98%
35011,New Mexico,De Baca County,1927,956,971,897,931,545,573,1118,809,No,41.98%,6,0%,758,39.34%
35013,New Mexico,Doña Ana County,214445,105533,108912,97485,100963,31709,31354,63063,151382,Yes,70.59%,4557,2%,142403,66.41%